"...Ḥájíbu'd-Dawlih	"...Hajibu'd-Dawlih	1
"Alláho'	"Allaho'	1
"Alláho	"Allaho	1
"Alláh–u–Abhá"!	"Alláh-u-Abhá"!	1
"Alláh–u–Abhá".'[30]	"Alláh-u-Abhá".'[30]	1
"Alláh–u–Abhá,"which	"Alláh-u-Abhá,"which	1
"Alláh–u–Abhá,	"Alláh-u-Abhá,	1
"Azali"	"Azalí"	1
"BAHÁ’ÍSIS	"BAHAISIS	1
"BaháT',	"BahaT',	1
"Bahá’ísm"	"Bahaism"	1
"Bahá’ísm,"	"Bahaism,"	1
"Bahá’ísm,	"Bahá'ism,	1
"Bahá’ísmus";	"Bahá'ísmus";	1
"Bahá’íyyih,"	"Bahá'iyyih,"	1
"Shogi".	"Shoghi".	1
&Bahá’ísm,"	&Bahá'ism,"	1
'Abbúdcame	'Abbudcame	1
'Abbúdconsidered	'Abbudconsidered	1
'Abbúdinterceded,	'Abbudinterceded,	1
'Abbúdmade	'Abbudmade	1
'Abdu'r-Rasul-i-Mansur-i-Kás_háni	'Abdu'r-Rasul-i-Mansur-i-Kás_hání	1
'Akbar-i-Shahmirzadi[*]	'Akbar-i-S_háhmirzadi[*]	1
'Aliy-i-Nuri.	'Aliy-i-Núrí.	1
'Aliy-i-Ṭihráni.	'Aliy-i-Tihrani.	1
'Alláh–u–Abhá!'"	'Alláh-u-Abhá!'"	1
'Alláh–u–Abhá'".	'Alláh-u-Abhá'".	1
'Alláh–u–Abhá'--God	'Alláh-u-Abhá'--God	1
'Azali'	'Azalí'	1
'BAGDADI	'BAG_HDÁDI	1
'BAHÁ’ÍST	'BAHAIST	1
'Bahá’ísm'),	'Bahá'ism'),	1
'Bahá’ísm',	'Bahaism',	1
'Bahá’ísm'.	'Bahá'ism'.	1
'Bahá’ísm,	'Bahá'ism,	1
'Bahá’ísm-Religion	'Bahá'ism-Religion	1
'Bahá’ísm	'Bahaism	1
'Bahá’ísm.'	'Bahaism.'	1
'Bahá’ísm:	'Bahaism:	1
'Bahá’ísmus',	'Bahá'ismus',	1
'Bahá’ísmus',	'Bahá'ísmus',	1
'Bahá’ísmus'	'Bahá'ismus'	1
'Bahá’ísmus'.	'Bahá'ismus'.	1
'INAYATU'LLAH,	‘INÁYATU’LLÁH,	1
'Ibn-Abhár,"	'Ibn-Abhar,"	1
'Ibn-Abhár?'	'Ibn-Abhar?'	1
'KHAN	'K_HÁN	1
'Mullás	'Mullahs	1
'S_hayk_hi	'Shaykhi	1
'S_hayk_hlyah',	'Shaykhlyah',	1
'Shahinshah'	'S_háhinshah'	1
'SuBahá’íssion	'SuBahá'ission	1
'_Alláh–u–Abhá_'	'_Alláh-u-Abhá_'	1
'Ḥasan-i-Mázindaráni',	'Ḥasan-i-Mázindarání',	1
(Alláhumma),	(Allahumma),	1
(Alláh–u–Abhá),	(Alláh-u-Abhá),	1
(Bahá’ímw,	(Bahá'imw,	1
(Bahá’ísm)	(Bahaism)	1
(Bahá’ísm,	(Bahá'ism,	1
(Bahá’ísmau,	(Bahá'ismau,	1
(Bahá’ísmlrs,	(Bahá'ismlrs,	1
(Bahá’ísmrrs,	(Bahá'ismrrs,	1
(Bahá’ísmua,	(Bahá'ismua,	1
(Bahá’ísmu~,	(Bahá'ismu~,	1
(Bábs).	(Babs).	1
(Kás_háni),	(Kás_hání),	1
(Kás_háni).	(Kás_hání).	1
(Nuri'd-Din)	(Núrí'd-Din)	1
(Pás_háliks),	(Pashaliks),	1
(S_hahnáz	(S_háhnaz	1
(S_hayk_hu'l-Islám?)	(Shaykhu'l-Islám?)	1
(Shahr-i	(S_háhr-i	1
(_S_hayk_hu'l-Isláms_),	(_Shaykhu'l-Isláms_),	1
(_ismu'l-a'zam_)--Alláh–u–Abhá--has	(_ismu'l-a'zam_)--Alláh-u-Abhá--has	1
(al-Bayánu'l-'Arabi),	(al-Bayanu'l-'Arabi),	1
(‘Abbásid,	('Abbasid,	1
(‘Abdu’lláh,	(Abdulláh,	1
(‘Akkádemia	(Accademia	1
(‘Ulamás)	(Ulemas)	1
(Ḥáfiẓa),	(Hafiza),	1
.Ḥájíbu'd-Dawlih	.Hájíbu'd-Dawlih	1
1897du'lBaháShe	1897du'lBahaShe	1
20‘Abdu’lBahP's	20Abdu'lBahP's	1
ABU'L-FADL'S	ABU’L-FAḌL'S	1
ABU'L-QASIM AFNAN	ABÚ’L-QÁSIM AFNÁN	1
ABU'L-QASIM-I-FIRAHANI,	ABÚ’L-QÁSIM-I-FIRAHANI,	1
ABU'L-QASIM	ABÚ’L-QÁSIM	1
ABU’L-FADL,	ABU’L-FAḌL,	1
ABU’L-FADL	ABU’L-FAḌL	1
ABU’L-QASIM	ABÚ’L-QÁSIM	1
AFNAN,	AFNÁN,	1
AFNAN-I-KABIR	AFNÁN-I-KABIR	1
AFNAN	AFNÁN	1
AFNAN.	AFNÁN.	1
AGHSAN	AG_HṢÁN	1
ALLAH-VIRDI	ALLÁH-VIRDI	1
ALLÁH–U–ABHÁ,	ALLAHUABHÁ,	1
ALLÁH–U–ABHÁ	ALLÁH-U-ABHÁ	1
AQA KHAN-l-QÁ’IM-MAQAMI	ÁQÁ K_HÁN-l-QÁ’IM-MAQAMI	1
AQAY-I-KALIM	ÁQÁY-I-KALIM	1
Abhándhmgen	Abhandhmgen	1
Abhár)	Abhar)	1
Abhár, Ibn-i-Abhár	Abhar, Ibn-i-Abhar	1
Abhár,"	Abhar,"	1
Abu-Sa'id's	Abu-Sa‘íd's	1
Abú’l-Qásim-i-Kás_háni,	Abú’l-Qásim-i-Kás_hání,	1
Abú’l-Qásim-i-Kás_háni	Abú’l-Qásim-i-Kás_hání	1
Al-Bayánu'l-'Arabi	Al-Bayanu'l-'Arabi	1
Aliy-i-Nuri,	Aliy-i-Núrí,	1
Allamiy-i-Nuri,	Allamiy-i-Núrí,	1
Allamiy-i-Nuri	Allamiy-i-Núrí	1
Alláha	Allaha	1
Alláho’Abhá!	Allaho’Abhá!	1
Alláhs	Allahs	1
Alláhu'l-Mustaghath?'	Allahu'l-Mustaghath?'	1
Alláhu	Allahu	1
Alláhyar	Allahyar	1
Alláh–u–Abhá!"	Alláh-u-Abhá!"	1
Alláh–u–Abhá, Alláh–u–Abhá, Alláh–u–Abhá.	Alláh-u-Abhá, Alláh-u-Abhá, Alláh-u-Abhá.	1
Alláh–u–Abhá.--How	Alláh-u-Abhá.--How	1
Alláh–u–Abhá.	Alláh-u-Abhá.	1
Alláh–u–Abhá.[1]	Alláh-u-Abhá.[1]	1
Alláh–u–Abhá;	Alláh-u-Abhá;	1
Alláh–u–Abhá?"	Alláh-u-Abhá?"	1
Asadu’lláh-i-Kás_háni	Asadu’lláh-i-Kás_hání	1
Asadu’lláh-i-Ras_hti,	Asadu’lláh-i-Ras_htí,	1
Asadu’lláh-i-Ras_hti	Asadu’lláh-i-Ras_htí	1
Azali's	Azalí's	1
Azali)	Azalí)	1
Azalies	Azalíes	1
Azaliintriguesthat	Azalíintriguesthat	1
Azalil	Azalíl	1
Aḥmad-i-Kás_háni,[2]	Aḥmad-i-Kás_hání,[2]	1
Aḥmad-i-Kás_háni--secretly	Aḥmad-i-Kás_hání--secretly	1
Aḥmad-i-Kás_háni.	Aḥmad-i-Kás_hání.	1
Aḥmad-i-Kás_háni[1]	Aḥmad-i-Kás_hání[1]	1
B&fandBahá’íHistow,	B&fandBahá'iHistow,	1
BAHRAMSHAHI,	BAHRÁMS_HÁHI,	1
BAHÁ’U’LLÁHS	BAHÁ'U'LLAHS	1
BAHÁ’ÍES	BAHAIES	1
BAHÁ’ÍES	BAHÁ'ÍES	1
BAHÁ’ÍRAT	BAHÁ'IRAT	1
BAHÁ’ÍSM--A	BAHAISM--A	1
BAHÁ’ÍSM	BAHAISM	1
BAHÁ’ÍST	BAHAIST	1
BAHÁ’ÍSTS	BAHAISTS	1
BAHÁ’ÍYYIH	BAHÁ'IYYIH	1
BAHÁ’Ís,	BAHÁ'Is,	1
BAHÁ’Ís	BAHÁ'Is	1
BANANI.	BANÁNÍ.	1
BAYAN:	BAYÁN:	1
BEGAN	BÍQÁN	1
BEGAN.	BÍQÁN.	1
BYJALALU’D-DIN	BYJALÁLU’D-DIN	1
Babism-Bahá’ísm	Babism-Bahá'ism	1
Babísm	Bábísm	1
Babísm:	Bábísm:	1
Babísm_.	Bábísm_.	1
Babíyyih	Bábíyyih	1
Babúya).	Bábúya).	1
Badi‘s	Badis	1
Bag_hdádís,	Bag_hdádis,	1
Bag_hdádís	Bag_hdádis	1
Bahjíh,	Behjeh,	1
Bahjísu,	Bajisu,	1
Bahjít	Behjet	1
Bahjítabad,	Behjetabad,	1
Bahráms,	Bahrams,	1
BaháP'u'llPh	BahaP'u'llPh	1
BaháT	BahaT	1
BaháVu'Uti	BahaVu'Uti	1
BaháWBh	BahaWBh	1
BaháWEh	BahaWEh	1
BaháWWs	BahaWWs	1
BaháYi-Religion',	BahaYi-Religion',	1
BaháYu'llc&	BahaYu'llc&	1
Bahás	Bahas	1
Bahá’u’lláhh_.	Bahá'u'llahh_.	1
Bahá’u’lláhs'	Bahá'u'lláhs'	1
Bahá’u’lláhs'.	Bahá'u'llahs'.	1
Bahá’u’lláhs'.	Bahá'u'lláhs'.	1
Bahá’u’lláhs's	Bahá'u'llahs's	1
Bahá’u’lláhs	Bahá'u'lláhs	1
Bahá’u’lláhsi	Bahá'u'llahsi	1
Bahá’u’lláhst.)	Bahá'u'llahst.)	1
Bahá’u’lláhu'l-Abhá	Bahá'u'llahu'l-Abhá	1
Bahá’u’lláhu'l-Abhá.	Bahá'u'llahu'l-Abhá.	1
Bahá’íAdmimMdion,	Bahá'iAdmimMdion,	1
Bahá’íAdministmtion,	Bahá'iAdministmtion,	1
Bahá’íCenter	Bahá'iCenter	1
Bahá’íEpistemology',	Bahá'íEpistemology',	1
Bahá’íFaith.	Bahá'iFaith.	1
Bahá’íFeast	Bahá'iFeast	1
Bahá’íHisto?y	Bahá'iHisto?y	1
Bahá’íHistory.	Bahá'íHistory.	1
Bahá’íJmus,	Bahá'iJmus,	1
Bahá’íReligion	Bahá'iReligion	1
Bahá’íS--SECTARIAN	Bahá'iS--SECTARIAN	1
Bahá’íStudi@s	Bahá'iStudi@s	1
Bahá’íamss,	Bahá'iamss,	1
Bahá’íamus,	Bahá'iamus,	1
Bahá’íe_,	Bahá'íe_,	1
Bahá’íe_	Bahá'ie_	1
Bahá’íe_	Bahá'íe_	1
Bahá’íe_.	Bahá'ie_.	1
Bahá’íe_.	Bahá'íe_.	1
Bahá’íenus,	Bahá'ienus,	1
Bahá’íism	Bahaiism	1
Bahá’íj	Bahaij	1
Bahá’íl	Bahá'il	1
Bahá’íme.	Bahá'ime.	1
Bahá’ímm.	Bahá'imm.	1
Bahá’ímms,	Bahá'imms,	1
Bahá’ímnna,	Bahá'imnna,	1
Bahá’ímnus,	Bahá'imnus,	1
Bahá’ímrus,	Bahá'imrus,	1
Bahá’ímua,	Bahá'imua,	1
Bahá’ímur,	Bahá'imur,	1
Bahá’ímwts,	Bahá'imwts,	1
Bahá’íng	Bahá'ing	1
Bahá’írmus,	Bahá'irmus,	1
Bahá’ísister,	Bahá'isister,	1
Bahá’ísm' (_Bahá’ísmus_,	Bahá'ism' (_Bahá'ismus_,	1
Bahá’ísm'"'	Bahá'ism'"'	1
Bahá’ísm'),	Bahá'ism'),	1
Bahá’ísm','"	Bahá'ism','"	1
Bahá’ísm'.	Bahá'ism'.	1
Bahá’ísm'.[1]	Bahaism'.[1]	1
Bahá’ísm'38'	Bahá'ism'38'	1
Bahá’ísm's7	Bahá'ism's7	1
Bahá’ísm)	Bahaism)	1
Bahá’ísm, Bahá’íst)	Bahaism, Bahaist)	1
Bahá’ísm,"	Bahá'ism,"	1
Bahá’ísm,	Bahá'ísm,	1
Bahá’ísm--History--20th	Bahaism--History--20th	1
Bahá’ísm	Bahá'ísm	1
Bahá’ísm."	Bahaism."	1
Bahá’ísm.[15]	Bahaism.[15]	1
Bahá’ísm:	Bahá'ísm:	1
Bahá’ísm;	Bahaism;	1
Bahá’ísmaw,	Bahá'ismaw,	1
Bahá’ísme.	Bahá'isme.	1
Bahá’ísmns.	Bahá'ismns.	1
Bahá’ísmru,	Bahá'ismru,	1
Bahá’ísmuJ,	Bahá'ismuJ,	1
Bahá’ísmua,	Bahá'ismua,	1
Bahá’ísmur,	Bahá'ismur,	1
Bahá’ísmus)	Bahá'ismus)	1
Bahá’ísmus-Religion	Bahá'ismus-Religion	1
Bahá’ísmus-ungewisse	Bahá'ismus-ungewisse	1
Bahá’ísmus.	Bahá'ísmus.	1
Bahá’ísmus:	Bahá'ísmus:	1
Bahá’ísnrt~s.	Bahá'isnrt~s.	1
Bahá’íst.	Bahaist.	1
Bahá’ísts,	Bahá'ists,	1
Bahá’íteachings	Bahá'iteachings	1
Bahá’ítum	Bahá'ítum	1
Bahá’ítum.	Bahá'ítum.	1
Bahá’ítum._	Bahá'ítum._	1
Bahá’ítum_)	Bahá'itum_)	1
Bahá’ítum_	Bahá'itum_	1
Bahá’ítum_.	Bahá'itum_.	1
Bahá’ítum_.	Bahá'ítum_.	1
Bahá’íu'llah's	Bahá'iu'llah's	1
Bahá’íyouth,	Bahá'iyouth,	1
Bahá’íyyih,	Bahá'íyyih,	1
Banu-Bahjílah,	Banu-Bajilah,	1
Baqir-i-Kás_háni,	Baqir-i-Kás_hání,	1
Baqir-i-Kás_háni	Baqir-i-Kás_hání	1
Bayánda	Bayanda	1
Bayánic	Bayanic	1
Bayániyya	Bayaniyya	1
Bayániyya.	Bayaniyya.	1
Bayáns,	Beyens,	1
Bayáns.	Bayans.	1
Bayáns:	Bayans:	1
Bayánu'l-'Arabi	Bayanu'l-'Arabi	1
Bibi-Shahr-Banu,	Bibi-S_háhr-Banu,	1
Bibi-Shahrbanu,	Bibi-S_háhrbanu,	1
B~biandBaháYHisto,y	B~biandBahaYHisto,y	1
BÁBS	BABS	1
Bábs'fs	Babs'fs	1
Bábs'ls	Babs'ls	1
Bábs'u'k%h,	Babs'u'k%h,	1
Bábs'u'llBh	Babs'u'llBh	1
Bábs'u'llBh.	Babs'u'llBh.	1
Bábs,	Babs,	1
Bábsi	Babsi	1
Dhu'sh-Shahadatayn	Dhu'sh-S_háhadatayn	1
Diya'u'l-Ḥájíyyih,	Diya'u'l-Hajiyyih,	1
Diya'u'l-Ḥájíyyih	Diya'u'l-Hajiyyih	1
Diyau'l-Ḥájíyyih,	Diyau'l-Hajiyyih,	1
EnfBahá’íkssreO.	EnfBahá'ikssreO.	1
FADIL-I-YAZDÍ.	FAḌIL-I-YAZDÍ.	1
FADIL-i-MAZINDARANI,	FAḌIL-i-MÁZINDARÁNÍ,	1
FADIL-l-MAZINDARANI,	FAḌIL-l-MÁZINDARÁNÍ,	1
FARUHAR	FARÚḤÁR	1
FAZLU	FAḌLU	1
FURUHI	FURÚḤÍ	1
FURUTAN MUḤÁJÍR	FURÚTAN MUHAJIR	1
Faḍil-i-Mázindaráni--a	Faḍil-i-Mázindarání--a	1
Faḍil-i-Ṭihráni	Faḍil-i-Tihrani	1
Faḍlu'llah-i-Nuri,	Faḍlu'llah-i-Núrí,	1
Faḍlu'llah-i-Nuri[2]	Faḍlu'llah-i-Núrí[2]	1
Fárábís	Farabis	1
Fáṭimihs	Fatimihs	1
GÍQÁNGORO	GIKANGORO	1
HADI	HÁDÍ	1
HAKIMAN	ḤAKÍMAN	1
HAZIRA	ḤAẒÍRA	1
HONOUR.	HONÚR.	1
HOSSAIN	ḤUSAYN	1
HUSSEIN	ḤUSAYN	1
HabibAlláh	HabibAllah	1
Hashrim-i-Kás_háni,	Hashrim-i-Kás_hání,	1
I;azlu'lldl~-i-Nuri	I;azlu'lldl~-i-Núrí	1
IBN-I-ABHÁR	IBN-I-ABHAR	1
IBRAHIM-I-KHALIL	IBRAḤÍM-I-KHALIL	1
IMAM,	IMÁM,	1
IMAMATE	IMÁMATE	1
INABILITY	INABÍLITY	1
ISMA'IL-I-KASHANI	ISMA'IL-I-KÁS_HÁNÍ	1
Ibn-i-.Ḥájíb	Ibn-i-.Hájib	1
Ibn-i-Abhár's	Ibn-i-Abhar's	1
Ibn-i-Abhár:	Ibn-i-Abhar:	1
Ibn-i-Ḥájíb	Ibn-i-Hajib	1
Ibn-i-Ḥájíb	Ibn-i-Hajíb	1
Ibni-Abhár	Ibni-Abhar	1
Ibrahim-i-Abhári	Ibrahim-i-Abhari	1
Ibrahim-i-Kás_háni,[1]	Ibrahim-i-Kás_hání,[1]	1
Ibrahim-i-Kás_háni	Ibrahim-i-Kás_hání	1
Ibráhím-i-Abhárí	Ibráhím-i-Abharí	1
Iski-Shahr,	Iski-S_háhr,	1
Iski-Shahr.	Iski-S_háhr.	1
Isma'il-i-Kás_háni,	Isma'il-i-Kás_hání,	1
Isma'ili-S_hayk_hi	Isma'ili-Shaykhi	1
Iṣfahánian,	Isfahanian,	1
Iṣfahánl,	Isfahanl,	1
Iṣfahání	Esfahani	1
JALAL HAKIMAN,	JALÁL ḤAKÍMAN,	1
JAMAL	JAMÁL	1
JAMALU'D-DIN,	JAMÁLU'D-DIN,	1
JAMALU	JAMÁLU	1
Janiy-i-Kás_háni,[1]	Janiy-i-Kás_hání,[1]	1
Jinab-i-Faḍil-i-Mázindaráni,	Jinab-i-Faḍil-i-Mázindarání,	1
Jinab-i-Faḍil-i-Mázindaráni	Jinab-i-Faḍil-i-Mázindarání	1
Jinab-i-ibn-i-Abhár,	Jinab-i-ibn-i-Abhar,	1
KAM‘ALÍ'D-DIN	KAMÁLI'D-DIN	1
KASHANI.	KÁS_HÁNÍ.	1
KATIBPUR-SHAHIDI	KATIBPUR-S_HÁHIDI	1
KHADI'I	KHÁDÍ'I	1
KHAN,	K_HÁN,	1
KHAN-I-'AVAMID	K_HÁN-I-'AVAMID	1
KHAN-I-BALUCH	K_HÁN-I-BALUCH	1
KHURASAN KASHAN	K_HURASÁN KÁS_HÁN	1
KHURASAN,	K_HURASÁN,	1
KHURASAN.	K_HURASÁN.	1
KITÁBJf.	KITABJf.	1
K_hayyáms,	Khayyams,	1
K_hurasánís'	Khurasanis'	1
K_hurasánís	Khurasanis	1
K_hurasánís.	Khurasanis.	1
K_hániNuri,	K_hániNúrí,	1
K_hánum-i-Nuri,	K_hánum-i-Núrí,	1
Karim-i-Ṭihráni,	Karim-i-Tihrani,	1
Key-K_husraws	Key-Khusraws	1
Khalil-i-Kás_háni.	Khalil-i-Kás_hání.	1
Khan--1901.	K_hán--1901.	1
Khan--Come--‘Abbás	K_hán--Come--‘Abbás	1
Khan--absent	K_hán--absent	1
Khan--and	K_hán--and	1
Khan--but	K_hán--but	1
Khan--in	K_hán--in	1
Khan--letters	K_hán--letters	1
Khan--may	K_hán--may	1
Khan--thank	K_hán--thank	1
Khan--to	K_hán--to	1
Khan--was	K_hán--was	1
Khan--young,	K_hán--young,	1
Khan-Atash,	K_hán-Atash,	1
Khan-Baba Khan-i-Sardar.	K_hán-Baba K_hán-i-Sardar.	1
Khan-Baba-K_hán.	K_hán-Baba-K_hán.	1
Khan-Baligh--the	K_hán-Baligh--the	1
Khan-Khanan	K_hán-Khanan	1
Khan-Mac	K_hán-Mac	1
Khan-Nanih,	K_hán-Nanih,	1
Khan-i-'Arab.	K_hán-i-'Arab.	1
Khan-i-,	K_hán-i-,	1
Khan-i-Afghan.	K_hán-i-Afghan.	1
Khan-i-Afranj.	K_hán-i-Afranj.	1
Khan-i-Afrukhtih[1]	K_hán-i-Afrukhtih[1]	1
Khan-i-Afrukhtih]	K_hán-i-Afrukhtih]	1
Khan-i-Afshar	K_hán-i-Afshar	1
Khan-i-Amir	K_hán-i-Amir	1
Khan-i-Baluch	K_hán-i-Baluch	1
Khan-i-Baluch]	K_hán-i-Baluch]	1
Khan-i-Balyuz--and	K_hán-i-Balyuz--and	1
Khan-i-Bardsiri,	K_hán-i-Bardsiri,	1
Khan-i-Biglarbagi,[1]	K_hán-i-Biglarbagi,[1]	1
Khan-i-Chapar	K_hán-i-Chapar	1
Khan-i-Darughih	K_hán-i-Darughih	1
Khan-i-Darughih.[F1]	K_hán-i-Darughih.[F1]	1
Khan-i-Durrani,	K_hán-i-Durrani,	1
Khan-i-Fathabadi,	K_hán-i-Fathabadi,	1
Khan-i-Furughi,	K_hán-i-Furughi,	1
Khan-i-Garrasi	K_hán-i-Garrasi	1
Khan-i-Garrusi	K_hán-i-Garrusi	1
Khan-i-Ghaffari,[1]	K_hán-i-Ghaffari,[1]	1
Khan-i-Giranmayih,	K_hán-i-Giranmayih,	1
Khan-i-Gurji	K_hán-i-Gurji	1
Khan-i-Hidayat,[1]	K_hán-i-Hidayat,[1]	1
Khan-i-Hidayat	K_hán-i-Hidayat	1
Khan-i-Hidayat;	K_hán-i-Hidayat;	1
Khan-i-I(ishan!	K_hán-i-I(ishan!	1
Khan-i-Ilbagi,	K_hán-i-Ilbagi,	1
Khan-i-Iravani	K_hán-i-Iravani	1
Khan-i-Irvani.	K_hán-i-Irvani.	1
Khan-i-Javanshir.	K_hán-i-Javanshir.	1
Khan-i-Jurayni,[1]	K_hán-i-Jurayni,[1]	1
Khan-i-Jurayni	K_hán-i-Jurayni	1
Khan-i-Kalantar	K_hán-i-Kalantar	1
Khan-i-Khamsih	K_hán-i-Khamsih	1
Khan-i-Khu'i	K_hán-i-Khu'i	1
Khan-i-Khurre,	K_hán-i-Khurre,	1
Khan-i-Kirgan,	K_hán-i-Kirgan,	1
Khan-i-Kirgan.	K_hán-i-Kirgan.	1
Khan-i-Kirmani's[1]	K_hán-i-Kirmani's[1]	1
Khan-i-Kirmani--to	K_hán-i-Kirmani--to	1
Khan-i-Kirmani.[1]	K_hán-i-Kirmani.[1]	1
Khan-i-Kirmani.[36-3]	K_hán-i-Kirmani.[36-3]	1
Khan-i-Kirmani;	K_hán-i-Kirmani;	1
Khan-i-Kujuri,	K_hán-i-Kujuri,	1
Khan-i-Kurdistani.	K_hán-i-Kurdistani.	1
Khan-i-Mahallati.	K_hán-i-Mahallati.	1
Khan-i-Maydan-Qal'a'i	K_hán-i-Maydan-Qal'a'i	1
Khan-i-Milani,,	K_hán-i-Milani,,	1
Khan-i-Mrukhtih)	K_hán-i-Mrukhtih)	1
Khan-i-Mukri,	K_hán-i-Mukri,	1
Khan-i-Mukri.	K_hán-i-Mukri.	1
Khan-i-Mustawfi,	K_hán-i-Mustawfi,	1
Khan-i-Nu'ri,	K_hán-i-Nu'ri,	1
Khan-i-Nuri.	K_hán-i-Núrí.	1
Khan-i-Nuri;	K_hán-i-Núrí;	1
Khan-i-Pahlavan,	K_hán-i-Pahlavan,	1
Khan-i-Qal'a-Mahmudf.	K_hán-i-Qal'a-Mahmudf.	1
Khan-i-Qal'a-Mahmudi	K_hán-i-Qal'a-Mahmudi	1
Khan-i-Qal'a-Maḥmúd',	K_hán-i-Qal'a-Maḥmúd',	1
Khan-i-Qarachih-Daghi	K_hán-i-Qarachih-Daghi	1
Khan-i-Qarachih-Daghi.	K_hán-i-Qarachih-Daghi.	1
Khan-i-Qaraguzlu,	K_hán-i-Qaraguzlu,	1
Khan-i-Qashqa'i,	K_hán-i-Qashqa'i,	1
Khan-i-Qazvini[F1]).	K_hán-i-Qazvini[F1]).	1
Khan-i-Qájár-i-Quyunlu,	K_hán-i-Qájár-i-Quyunlu,	1
Khan-i-Qá’im-Maqami,	K_hán-i-Qá’im-Maqami,	1
Khan-i-S_hírází,	K_hán-i-S_hírází,	1
Khan-i-Sarraf.	K_hán-i-Sarraf.	1
Khan-i-Sartip.	K_hán-i-Sartip.	1
Khan-i-Sartip],	K_hán-i-Sartip],	1
Khan-i-Sarvistani,	K_hán-i-Sarvistani,	1
Khan-i-Shahsavan,	K_hán-i-S_háhsavan,	1
Khan-i-Shavirdi,[1]	K_hán-i-Shavirdi,[1]	1
Khan-i-Shaybani,	K_hán-i-Shaybani,	1
Khan-i-Sipihr	K_hán-i-Sipihr	1
Khan-i-Suq-i-Abyad.	K_hán-i-Suq-i-Abyad.	1
Khan-i-Tunukabani,	K_hán-i-Tunukabani,	1
Khan-i-Tunukabuni,	K_hán-i-Tunukabuni,	1
Khan-i-Tunukabuni.	K_hán-i-Tunukabuni.	1
Khan-i-Turkaman,[1]	K_hán-i-Turkaman,[1]	1
Khan-i-Vakíl,	K_hán-i-Vakíl,	1
Khan-i-Vakíl	K_hán-i-Vakíl	1
Khan-i-Valí.	K_hán-i-Valí.	1
Khan-i-Varqá.	K_hán-i-Varqá.	1
Khan-i-Vazir.[F3]]	K_hán-i-Vazir.[F3]]	1
Khan-i-Vazlr	K_hán-i-Vazlr	1
Khan-i-Yavar,	K_hán-i-Yavar,	1
Khan-i-Yavar	K_hán-i-Yavar	1
Khan-i-Yavar.[F1]	K_hán-i-Yavar.[F1]	1
Khan-i-Yusufiyan.	K_hán-i-Yusufiyan.	1
Khan-i-Zand--in	K_hán-i-Zand--in	1
Khan-i-Zand.	K_hán-i-Zand.	1
Khan-very	K_hán-very	1
Khayyat-i-Kás_háni,	Khayyat-i-Kás_hání,	1
Khán-Nanih,	K_hán-Nanih,	1
Khán-Nanih.	K_hán-Nanih.	1
Khán-Nanih;	K_hán-Nanih;	1
Khán-i-Kirmání's	K_hán-i-Kirmání's	1
Khán-i-Núrí,	K_hán-i-Núrí,	1
Khán-i	K_hán-i	1
Kás_háni's	Kás_hání's	1
Kás_hánih.'	Kashanih.'	1
Kás_hánis	Kashanis	1
Káẓim-i-Ras_hti,[1]	Káẓim-i-Ras_htí,[1]	1
Káẓim-i-Ras_hti.[4]	Káẓim-i-Ras_htí.[4]	1
LOVE--BANANI	LOVE--BANÁNÍ	1
LiBahá’írie	LiBahá'irie	1
MAHABHÁRATA--[underlined]	MAHABHARATA--[underlined]	1
MAS_HRIQU’L-AD_HKÁRS,	MASHRIQU'L-ADHKARS,	1
MAZINDARAN.	MÁZINDARÁN.	1
MAḤMÚD-I-KASHANI	MAḤMÚD-I-KÁS_HÁNÍ	1
MIHDI.	MIHDÍ.	1
MIHDIY-I-RAS_HTI'S	MIHDÍY-I-RAS_HTÍ'S	1
MIHDIZADIH,	MIHDÍZADIH,	1
MONEER	MUNÍR	1
MONEER.	MUNÍR.	1
MULLA ‘ALÍ-AKBAR-I-SHAHMÍRZÁDI	MULLÁ ‘ALÍ-AKBAR-I-S_HÁHMIRZADI	1
MUḤAMMAD ‘ALÍ	MUḤAMMAD-‘ALÍ	1
MUḤAMMAD-TAQI, IBN-I-ABHÁR	MUḤAMMAD-TAQÍ, IBN-I-ABHAR	1
MUḤAMMAD-TAQIY-I-AFNAN	MUḤAMMAD-TAQIY-I-AFNÁN	1
MUḤÁJÍR,	MUHAJIR,	1
Majíd Khan-i-Ahi,	Majíd() K_hán-i-Ahi,	1
Majíd,	Majíd(),	1
Majíd-i-Áhí,	Majíd()-i-Áhí,	1
Majíd.'[49]	Majíd().'[49]	1
Majíd.	Majíd().	1
Majídi,	Majidi,	1
Majídis	Majidis	1
Mas_hhadi	Mashadi	1
Mas_hriqu’l-Ad_hkárs,	Mashrak-el-Azkars,	1
Mas_hriqu’l-Ad_hkárs,	Mashriqu'l-Adhkárs,	1
Mas_hriqu’l-Ad_hkárs	Mashrekul-Azkars	1
Mas_hriqu’l-Ad_hkárs.	Mashrak-el-Azkars.	1
Mas_hriqu’l-Ad_hkárs.	Mashriqu'l-Adhkars.	1
Mas_hriqu’l-Ad_hkárs.	Mashriqu'l-Adkars.	1
Mas_hriqu’l-Ad_hkárs.lO	Mashriqu'l-Adhkars.lO	1
Maḥmúd-Kás_háni:	Maḥmúd-Kás_hání:	1
Maḥmúd-i-Kás_háni,[1]	Maḥmúd-i-Kás_hání,[1]	1
Maḥmúd-i-Kás_háni.	Maḥmúd-i-Kás_hání.	1
Maḥmúd-i-Kás_háni;	Maḥmúd-i-Kás_hání;	1
Maḥmúdi,	Mahmoodi,	1
Maḥmúdi.	Mahmoodi.	1
Mihdíy-i-Kás_háni,	Mihdíy-i-Kás_hání,	1
Mihdíy-i-Kás_háni	Mihdíy-i-Kás_hání	1
Mihdíy-i-Kás_háni.[1]	Mihdíy-i-Kás_hání.[1]	1
Mihdíy-i-Kás_háni.[33]	Mihdíy-i-Kás_hání.[33]	1
Mihdíy-i-Ras_hti,[1]	Mihdíy-i-Ras_htí,[1]	1
Mihdíy-i-Ras_hti--like	Mihdíy-i-Ras_htí--like	1
Mihdíy-i-Sharif-i-Kás_háni,	Mihdíy-i-Sharif-i-Kás_hání,	1
Mihidiy-i-Ras_hti.	Mihidiy-i-Ras_htí.	1
Muhsin-i-Fayd-i-Kás_háni's	Muhsin-i-Fayd-i-Kás_hání's	1
Mullábashi	Mullabashi	1
Mullámmad	Mullammad	1
Mullás	Mollas	1
Mullás.... Bahá’ísm,	Mullahs.... Bahaism,	1
Mulláshir	Mollashir	1
Mullázadih	Mullazadih	1
Munír-i-Kás_háni,	Munír-i-Kás_hání,	1
Muníreh,	Munírih,	1
Murgh-i-Naw-Rúzi	Murgh-i-Nawruzi	1
Mushin-i-Fayd-i-Kás_háni's	Mushin-i-Fayd-i-Kás_hání's	1
Mustawfiy-i-Nuri.	Mustawfiy-i-Núrí.	1
Muḥammad-Baqir-i-Kás_háni, Khayyat-Bashiy-i-Kás_háni,	Muḥammad-Baqir-i-Kás_hání, Khayyat-Bashiy-i-Kás_hání,	1
Muḥammad-Baqir-i-Kás_háni	Muḥammad-Baqir-i-Kás_hání	1
Muḥammad-Baqir-i-Ras_hti	Muḥammad-Baqir-i-Ras_htí	1
Muḥammad-Baqir-i-Ras_hti[1]	Muḥammad-Baqir-i-Ras_htí[1]	1
Muḥammad-Baqir-i-Ṭihráni,	Muḥammad-Baqir-i-Tihrani,	1
Muḥammad-Ibrahim-i-Kás_háni	Muḥammad-Ibrahim-i-Kás_hání	1
Muḥammad-Ibrahim-i-Nazir-i-Kás_háni,	Muḥammad-Ibrahim-i-Nazir-i-Kás_hání,	1
Muḥammad-Ibrahim-i-Nazir-i-Kás_háni	Muḥammad-Ibrahim-i-Nazir-i-Kás_hání	1
Muḥammad-Isma'il-i-Dhabih-i-Kás_háni,	Muḥammad-Isma'il-i-Dhabih-i-Kás_hání,	1
Muḥammad-Isma'il-i-Kás_háni,	Muḥammad-Isma'il-i-Kás_hání,	1
Muḥammad-Javád-i-Kás_háni,	Muḥammad-Javád-i-Kás_hání,	1
Muḥammad-Javád-i-Kás_háni	Muḥammad-Javád-i-Kás_hání	1
Muḥammad-Khan-i-Baluch,	Muḥammad-K_hán-i-Baluch,	1
Muḥammad-Sa'id,	Muḥammad-Sa‘íd,	1
Muḥammad-Taqiy-i-Abhári, Ibn-i-Abhár;	Muḥammad-Taqiy-i-Abhari, Ibn-i-Abhar;	1
Muḥammad-i-Mu'allim-i-Nuri--whom	Muḥammad-i-Mu'allim-i-Núrí--whom	1
Muḥammad-‘Alís--the	Muḥammad-'Alis--the	1
Muḥammad-‘Alís:	Muḥammad-'Alis:	1
Muḥammad-‘Alíy-i-	Muḥammad-'Aliy-i-	1
Muḥammad-‘Alíy-i-Afnán,	Muḥammad-'Aliy-i-Afnán,	1
Muḥammad-‘Alíy-i-Afnán,[1]	Muḥammad 'Aliy-i-Afnán,[1]	1
Muḥammad-‘Alíy-i-Aḥmaduf-i-Mílání:	Muḥammad-'Alíy-i-Aḥmaduf-i-Mílání:	1
Muḥammad-‘Alíy-i-Barfarushi,	Muḥammad-'Aliy-i-Barfarushi,	1
Muḥammad-‘Alíy-i-Barfurushi[F2]	Muḥammad-'Aliy-i-Barfurushi[F2]	1
Muḥammad-‘Alíy-i-Barfurushi_	Muḥammad-'Aliy-i-Barfurushi_	1
Muḥammad-‘Alíy-i-Faizi,	Muḥammad Aliy-i-Faizi,	1
Muḥammad-‘Alíy-i-Gazir.	Muḥammad-'Aliy-i-Gazir.	1
Muḥammad-‘Alíy-i-Gazur,	Muḥammad-'Aliy-i-Gazur,	1
Muḥammad-‘Alíy-i-Hamzih,	Muḥammad-'Aliy-i-Hamzih,	1
Muḥammad-‘Alíy-i-Hujjat,	Muḥammad-'Aliy-i-Hujjat,	1
Muḥammad-‘Alíy-i-Isfihani.	Muḥammad-'Aliy-i-Isfihani.	1
Muḥammad-‘Alíy-i-Iṣfahání;	Muḥammad-'Aliy-i-Iṣfahání;	1
Muḥammad-‘Alíy-i-Jilawdar	Muḥammad 'Aliy-i-Jilawdar	1
Muḥammad-‘Alíy-i-Jilawdar-i-Yazdí,	Muḥammad-'Aliy-i-Jilawdar-i-Yazdí,	1
Muḥammad-‘Alíy-i-Kad-Khuda,	Muḥammad-'Aliy-i-Kad-Khuda,	1
Muḥammad-‘Alíy-i-Kalbasi.	Muḥammad-'Aliy-i-Kalbasi.	1
Muḥammad-‘Alíy-i-Mahallati.	Muḥammad-'Aliy-i-Mahallati.	1
Muḥammad-‘Alíy-i-Musavi]	Muḥammad-'Aliy-i-Musavi]	1
Muḥammad-‘Alíy-i-Nahri	Muḥammad 'Aliy-i-Nahri	1
Muḥammad-‘Alíy-i-Nahri.	Muḥammad-'Aliy-i-Nahri.	1
Muḥammad-‘Alíy-i-Nahrí,	Muḥammad-'Alíy-i-Nahrí,	1
Muḥammad-‘Alíy-i-Nahrí	Muḥammad-'Alíy-i-Nahrí	1
Muḥammad-‘Alíy-i-Nahrí]	Muḥammad-'Alíy-i-Nahrí]	1
Muḥammad-‘Alíy-i-Najafabadi,	Muḥammad-'Aliy-i-Najafabadi,	1
Muḥammad-‘Alíy-i-Qa'ini.	Muḥammad-'Aliy-i-Qa'ini.	1
Muḥammad-‘Alíy-i-Qazvini,	Muḥammad-'Aliy-i-Qazvini,	1
Muḥammad-‘Alíy-i-Qazvini	Muḥammad-'Aliy-i-Qazvini	1
Muḥammad-‘Alíy-i-Qazvini_	Muḥammad-'Aliy-i-Qazvini_	1
Muḥammad-‘Alíy-i-Sabzivari,	Muḥammad-'Aliy-i-Sabzivari,	1
Muḥammad-‘Alíy-i-Sabzivari	Muḥammad-'Aliy-i-Sabzivari	1
Muḥammad-‘Alíy-i-Sah&ni,	Muḥammad-Aliy-i-Sah&ni,	1
Muḥammad-‘Alíy-i-Salmani,	Muḥammad Aliy-i-Salmani,	1
Muḥammad-‘Alíy-i-Salmani,[**]	Muḥammad-'Aliy-i-Salmani,[**]	1
Muḥammad-‘Alíy-i-Salmani,[1]	Muḥammad-'Aliy-i-Salmani,[1]	1
Muḥammad-‘Alíy-i-Salmani,[2]	Muḥammad-'Aliy-i-Salmani,[2]	1
Muḥammad-‘Alíy-i-Salmani	Muḥammad Aliy-i-Salmani	1
Muḥammad-‘Alíy-i-Salmani[1]	Muḥammad Aliy-i-Salmani[1]	1
Muḥammad-‘Alíy-i-Salmánií)	Muḥammad-'Alíy-i-Salmánií)	1
Muḥammad-‘Alíy-i-Salmání,	Muḥammad-'Alíy-i-Salmání,	1
Muḥammad-‘Alíy-i-Sayyah]	Muḥammad-'Aliy-i-Sayyah]	1
Muḥammad-‘Alíy-i-Tabib,	Muḥammad-'Aliy-i-Tabib,	1
Muḥammad-‘Alíy-i-Tabrizi.	Muḥammad 'Aliy-i-Tabrizi.	1
Muḥammad-‘Alíy-i-Tabíb	Muḥammad 'Alíy-i-Tabíb	1
Muḥammad-‘Alíy-i-Tambaku-Furush.	Muḥammad-'Aliy-i-Tambaku-Furush.	1
Muḥammad-‘Alíy-i-Tambaku-Furush[4]	Muḥammad-'Aliy-i-Tambaku-Furush[4]	1
Muḥammad-‘Alíy-i-Tambakufurush-i-Iṣfahání,	Muḥammad 'Aliy-i-Tambakufurush-i-Iṣfahání,	1
Muḥammad-‘Alíy-i-Tambakufurush-i-Iṣfahání	Muḥammad 'Aliy-i-Tambakufurush-i-Iṣfahání	1
Muḥammad-‘Alíy-i-Yazdí;	Muḥammad-'Aliy-i-Yazdí;	1
Muḥammad-‘Alíy-i-Zanjani	Muḥammad 'Aliy-i-Zanjani	1
Muḥammad-‘Alíy-i-Zanjani;[F3]	Muḥammad-'Aliy-i-Zanjani;[F3]	1
Muḥammad-‘Alíy-i-Zunizi,	Muḥammad-'Aliy-i-Zunizi,	1
Muḥammad-‘Alíy-i-Zunizi.	Muḥammad-'Aliy-i-Zunizi.	1
Muḥammad-‘Alíy-i-Zunuzi),	Muḥammad-'Aliy-i-Zunuzi),	1
Muḥammad-‘Alíy-i-Zunuzi	Muḥammad-Aliy-i-Zunuzi	1
Muḥammad-Ḥusayn-i-Kás_háni,	Muḥammad-Ḥusayn-i-Kás_hání,	1
Mázindaráni's	Mázindarání's	1
Mázindaráni[41]	Mázindarání[41]	1
Mír'atu'l-Azaliyyih	Mír'atu'l-Azalíyyih	1
Mírzás	Mirzas	1
Mírzáy-i-Halabi-Saz,	Mirzay-i-Halabi-Saz,	1
Mírzáy-i-Halabi-Saz,[1]	Mirzay-i-Halabi-Saz,[1]	1
Mírzáy-i-Hamadani,	Mirzay-i-Hamadani,	1
M‘AKKÁY	MACKAY	1
M‘Akkáh	M'Akkah	1
NABIL-I-A'ZAM.	NABÍL-I-A'ZAM.	1
NASIRI'D-DIN	NÁṢIRI’D-DÍN	1
NURI,	NÚRÍ,	1
NURU'LLAH	NÚRU’LLÁH	1
Na'im-i-Nuri,	Na'im-i-Núrí,	1
Nasru'llah-Khan-i-Nuri,	Nasru'llah-K_hán-i-Núrí,	1
Nasru'llah-i-Nuri,	Nasru'llah-i-Núrí,	1
Navváb/Navvábbih	Navváb/Navábbih	1
Navvábih,	Navvabih,	1
Navvábih	Navvabih	1
Ni'matu'llah-i-Mázindaráni	Ni'matu'llah-i-Mázindarání	1
Nuri'd-Din-i-Zayn	Núrí'd-Din-i-Zayn	1
Nuri'd-Din.)	Núrí'd-Din.)	1
Nuri'd-Din.	Núrí'd-Din.	1
Nuri'd-Din:	Núrí'd-Din:	1
Nuri'ddin-i-Zayn,	Núrí'ddin-i-Zayn,	1
Nuri).	Núrí).	1
Nuri	Núrí	1
NÚRÍSHED	NOURISHED	1
Núri’d-Dín,	Núrí’d-Dín,	1
Port-Sa'id.	Port-Sa‘íd.	1
Pás_hálic	Pashalic	1
Pás_hálic.	Pashalic.	1
Pás_hálik	Pashalik	1
Pás_hálik.[1]	Pashalik.[1]	1
Pás_háy-i-Maku'i	Pashay-i-Maku'i	1
Pás_háy-i-Qibrisi)	Pashay-i-Qibrisi)	1
P‘AKKÁGE	PACKAGE	1
Qayyúmu’l-Asmá’slightly	Qayyúmu’l-Asmá’'slightly	1
Qájáriyya.	Qajariyya.	1
Qájárs).	Qajars).	1
Qájárs,[1]	Qajars,[1]	1
Qájárs.'	Qajars.'	1
Qájárs.]	Qajars.]	1
Qájárs:	Qajars:	1
RABBANI, RUHIYYIH.	RABBÁNÍ, RÚḤÍYYIH.	1
RABBANI, RÚHÍYYIH,	RABBÁNÍ, RÚḤÍYYIH,	1
RABBANI	RABBÁNÍ	1
RAHIM RAHIMIYAN,	RAḤÍM RAḤÍMIYAN,	1
RAHIMKHAN	RAḤÍMK_HÁN	1
REMUNEREES."[^539]	REMUNÍREES."[^539]	1
RESULTANT	RESULṬÁNT	1
ROUHANI'S	RÚḤÁNI'S	1
ROUHANI,	RÚḤÁNI,	1
RUHI,	RÚḤÍ,	1
RUHI	RÚḤÍ	1
Rafi'-i-Nuri,	Rafi'-i-Núrí,	1
Ramaḍáns	Ramadans	1
Ras_hti.	Ras_htí.	1
Ras_hti’s	Ras_htí’s	1
Rawdih-Khan-i-Yazdí_.	Rawdih-K_hán-i-Yazdí_.	1
SHAHIN	S_HÁHIN	1
SHIRAZ;	S_HÍRÁZ;	1
SHIRAZ[^484]	S_HÍRÁZ[^484]	1
SIYAH-CHAL,	SÍYÁH-C_HÁL,	1
SIYAH-CHAL--the	SÍYÁH-C_HÁL--the	1
SULAYMAN KHAN-I-TUNUKABANI	SULAYMÁN K_HÁN-I-TUNUKABANI	1
S_hahnáz,	S_háhnaz,	1
S_hayk_hL	ShaykhL	1
S_hayk_ha'l-Ishraq.	Shaykha'l-Ishraq.	1
S_hayk_hdoms,	Shaykhdoms,	1
S_hayk_hi-Bala-	Shaykhi-Bala-	1
S_hayk_hi-Bala-Sari	Shaykhi-Bala-Sari	1
S_hayk_his--his	Shaykhis--his	1
S_hayk_his;	Shaykhis;	1
S_hayk_hism';	Shaykhism';	1
S_hayk_hiyya-Juriyya,	Shaykhiyya-Juriyya,	1
S_hayk_hiyya-Juriyya	Shaykhiyya-Juriyya	1
S_hayk_hiyya	Shaykhiyya	1
S_hayk_hn'l-	Shaykhn'l-	1
S_hayk_hs,	Sheiks,	1
S_hayk_hs.[30]	Shaykhs.[30]	1
S_hayk_hu'l-'Ajam	Shaykhu'l-'Ajam	1
S_hayk_hu'l-'Iraqayn	Shaykhu'l-'Iraqayn	1
S_hayk_hu'l-'ulama,	Shaykhu'l-'ulama,	1
S_hayk_hu'l-Ishraq	Shaykhu'l-Ishraq	1
S_hayk_hu'l-Islám,[2]	Shaykhu'l-Islám,[2]	1
S_hayk_hu'l-Islám--who	Shaykhu'l-Islám--who	1
S_hayk_hu'l-Islám.	Shaykhu'l-Islám.	1
S_hayk_hu'l-Islám.[1]	Shaykhu'l-Islám.[1]	1
S_hayk_hu'l-Islám?"	Shaykhu'l-Islám?"	1
S_hayk_hu'l-Islám[1];	Shaykhu'l-Islám[1];	1
S_hayk_hu'l-Islám[3]	Shaykhu'l-Islám[3]	1
S_hayk_hu'r-Ra'is)	Shaykhu'r-Ra'is)	1
S_hayk_hu'r-Ra'is,[1]	Shaykhu'r-Ra'is,[1]	1
S_hayk_hu'r-Ra'is,[2]	Shaykhu'r-Ra'is,[2]	1
S_hayk_hu'r-Rais	Shaykhu'r-Rais	1
S_hayk_hu'sh-Shari'a.	Shaykhu'sh-Shari'a.	1
S_hayk_hu'sh-Shi'a	Shaykhu'sh-Shi'a	1
S_hayk_hu'sh	Shaykhu'sh	1
S_hayk_hu't-Ta'ifa,        S_hayk_hu't-Ta'ifa,	Shaykhu't-Ta'ifa,        Shaykhu't-Ta'ifa,	1
S_hayk_hu't-Ta'ifa.	Shaykhu't-Ta'ifa.	1
S_hayk_hu	Shaykhu	1
S_hayk_huna	Shaykhuna	1
S_hayk_hí,	Shaykhí,	1
S_hayk_hí;	Shaykhí;	1
S_hayk_hís,	Shaykhís,	1
S_hírázís.	S_hírázis.	1
S_hí‘ahs--and	Shi'ihs--and	1
S_hí‘ahs--but	Shi'ahs--but	1
S_hí‘ahs--left	Shi'ahs--left	1
S_hí‘ahs	Shí‘ahs	1
S_hí‘ahs.	Shiahs.	1
S_hí‘ahs:	Shi'ahs:	1
S_hí‘ahs;	Shi'ahs;	1
S_hí‘ahs;	Shi'ihs;	1
Sa'id Khan-i-Ansari	Sa‘íd K_hán-i-Ansari	1
Sa'id Khan-i-Ansari;	Sa‘íd K_hán-i-Ansari;	1
Sa'id Khan-i-Kurdistani,	Sa‘íd K_hán-i-Kurdistani,	1
Sa'id-i-Ardistani.	Sa‘íd-i-Ardistani.	1
Sa'id-i-Ardistani.24	Sa‘íd-i-Ardistani.24	1
Sa'id-i-Ardistani.[24]	Sa‘íd-i-Ardistani.[24]	1
Sa'id-i-Ardistan´i.	Sa‘íd-i-Ardistan´i.	1
Sa'id-i-Hindi	Sa‘íd-i-Hindi	1
Sa'id-i-Hindi.	Sa‘íd-i-Hindi.	1
Sa'id-i-Hindi_	Sa‘íd-i-Hindi_	1
Sa'íd	Sa‘íd	1
Sa’id	Sa‘íd	1
Sa‘ída,	Sa'ida,	1
Sa‘ída.	Sa'ida.	1
Sa‘ídah,	Sa'idah,	1
Sa‘ídi	Sa'idi	1
Sa‘ídih	Sa'idih	1
Sa‘ídu'l-Ulama!'"[F25]	Sa'idu'l-Ulama!'"[F25]	1
Sa‘ídu'l-Ulama	Sa'idu'l-Ulama	1
Shahab.	S_háhab.	1
Shahabad],	S_háhabad],	1
Shahabidin	S_háhabidin	1
Shahada	S_háhada	1
Shahadatayn	S_háhadatayn	1
Shahamirzad	S_háhamirzad	1
Shahan-shah	S_háhan-shah	1
Shahansahi	S_háhansahi	1
Shahbabek.	S_háhbabek.	1
Shahdiz	S_háhdiz	1
Shahi-	S_háhi-	1
Shahi.	S_háhi.	1
Shahid-i-Mazkan	S_háhid-i-Mazkan	1
Shahid-ibn-i-Shahid	S_háhid-ibn-i-S_háhid	1
Shahid-martyr	S_háhid-martyr	1
Shahid.[9]	S_háhid.[9]	1
Shahidinejad	S_háhidinejad	1
Shahik,	S_háhik,	1
Shahin	S_háhin	1
Shahinshah,	S_háhinshah,	1
Shahjahan	S_háhjahan	1
Shahl;	S_háhl;	1
Shahla	S_háhla	1
Shahmirzad,	S_háhmirzad,	1
Shahmirzadi	S_háhmirzadi	1
Shahmirzadi.	S_háhmirzadi.	1
Shahnama	S_háhnama	1
Shahnid	S_háhnid	1
Shahnáz,	S_háhnáz,	1
Shahpur	S_háhpur	1
Shahqoli	S_háhqoli	1
Shahr)	S_háhr)	1
Shahr-Banu.	S_háhr-Banu.	1
Shahr-Bánú	S_háhr-Bánú	1
Shahr-Khwastan [Shahr-Khastan]	S_háhr-Khwastan [S_háhr-Khastan]	1
Shahr-Khwastan's	S_háhr-Khwastan's	1
Shahr-Khwastan	S_háhr-Khwastan	1
Shahr-banu.	S_háhr-banu.	1
Shahr-i-	S_háhr-i-	1
Shahr-i-Babak	S_háhr-i-Babak	1
Shahr-i-Naw,	S_háhr-i-Naw,	1
Shahr-i-Ray	S_háhr-i-Ray	1
Shahr-i-Ray.	S_háhr-i-Ray.	1
Shahr-i-Sabz	S_háhr-i-Sabz	1
Shahrbanu,	S_háhrbanu,	1
Shahrbanu	S_háhrbanu	1
Shahrbanuyih	S_háhrbanuyih	1
Shahriar	S_háhriar	1
Shahristan,	S_háhristan,	1
Shahristan	S_háhristan	1
Shahristani	S_háhristani	1
Shahrivar,	S_háhrivar,	1
Shahrivar.	S_háhrivar.	1
Shahriya-Ḥasan.	S_háhriya-Ḥasan.	1
Shahriyars,	S_háhriyars,	1
Shahrood,	S_háhrood,	1
Shahru'l	S_háhru'l	1
Shahrud)	S_háhrud)	1
Shahrud:	S_háhrud:	1
Shahrukh's,	S_háhrukh's,	1
Shahrukh's	S_háhrukh's	1
Shahs!"	S_háhs!"	1
Shahs:	S_háhs:	1
Shahvirdi.	S_háhvirdi.	1
Shahzadeh,	S_háhzadeh,	1
Shahzadeh	S_háhzadeh	1
Shahzadih	S_háhzadih	1
Shi'i-S_hayk_hi	Shi'i-Shaykhi	1
Shirvan-Shahs,	Shirvan-S_háhs,	1
Sháhan-S_háh	S_háhan-S_háh	1
Sháhrúd	S_háhrúd	1
Sháhrúd.	S_háhrúd.	1
SuBahá’íssive	SuBahá'issive	1
SuBahá’íssiveness.	SuBahá'issiveness.	1
Súrahs,	Surihs,	1
Súrahs	Surahs	1
Súrahs:	Surihs:	1
TAQI	TAQÍ	1
THEBahá’íCOm	THEBahá'iCOm	1
Tang-i-Alláhu-Akbar,	Tang-i-Allahu-Akbar,	1
Tangi-Alláhu	Tangi-Allahu	1
Taqiy-i-Nuri,	Taqiy-i-Núrí,	1
Upeksha--Íqánimity.	Upeksha--Equanimity.	1
Valís	Valis	1
Varqás's	Varqas's	1
Vizírs	Viziers	1
Vizírs.	Viziers.	1
Word--ALLÁH–U–ABHÁ!	Word--ALLÁH-U-ABHÁ!	1
YAHYA,	YAḤYÁ,	1
Yazdígird-i-Shahriyar	Yazdígird-i-S_háhriyar	1
Yaḥyáh)	Yahyah)	1
Yaḥyáh.'[7]	Yahyah.'[7]	1
Yaḥyáh.'[8]	Yahyah.'[8]	1
Yaḥyáy--i-Dárábí,	Yahyáy--i-Dárábí,	1
Yaḥyáy-i-Daraba)	Yahyay-i-Daraba)	1
Yaḥyáy-i-Darábí,	Yahyáy-i-Darábí,	1
Yaḥyáy-i-Dárábí--the	Yahyay-i-Dárábí--the	1
Yaḥyáy-i-Dárábí.	Yahyay-i-Dárábí.	1
Yaḥyáyi-Dárábí	Yahyayi-Dárábí	1
Yusif-i-Ras_hti	Yusif-i-Ras_htí	1
Yusuf-Khan-i-Thabit	Yusuf-K_hán-i-Thabit	1
ZaÍqánf,	ZaIqanf,	1
i-Shahmirzadi,	i-S_háhmirzadi,	1
[Alláh–u–Abhá],	[Alláh-u-Abhá],	1
[Bahá’ísm]	[Bahá'ism]	1
[Mírzáy-i-S_hírází]	[Mirzay-i-S_hírází]	1
[‘Abdu’l-Majíd]	[‘Abdu’l-Majíd()]	1
[‘Abdu’lBabB]	[Abdu'lBabB]	1
[‘Akkál.	[Akkal.	1
\lKhán-i-Kalántar.	\lK_hán-i-Kalántar.	1
_(Bahá’ísm,	_(Bahá'ism,	1
_Alláho’Abhá_	_Allaho’Abhá_	1
_Alláh–u–Abhá_	_Alláh-u-Abhá_	1
_Bahá’u’lláhsi	_Bahá'u'llahsi	1
_Bahá’ísm:	_Bahá'ism:	1
_Bahá’ísm_.	_Bahaism_.	1
_Bahá’ísmus_,	_Bahá'ismus_,	1
_Bahá’ísmus_	_Bahá'ismus_	1
_Bábs_	_Babs_	1
_S_hayk_hi	_Shaykhi	1
_Shahadat_	_S_háhadat_	1
_Shahnamih_,	_S_háhnamih_,	1
_al-Bahá’íyyah_	_al-Bahá'iyyah_	1
_túmáns_]	_tumans_]	1
againstaUBahá’íhistoricaltmditionsandawxmts	againstaUBahá'ihistoricaltmditionsandawxmts	1
al-‘Abbási	al-'Abbasi	1
al-Ḥadít_ha,	al-Hádítha,	1
anti-S_hayk_hi	anti-Shaykhi	1
as-Sa’id	as-Sa‘íd	1
ash-Shahrastani,	ash-S_háhrastani,	1
ash-Shahrastani	ash-S_háhrastani	1
ash-Shahristani	ash-S_háhristani	1
at-Ṭihráni,	at-Tihrani,	1
autBahá’íly	autBahá'ily	1
authorities.--ABU’L-FADL	authorities.--ABU’L-FAḌL	1
himself.--ABU’L-FADL.	himself.--ABU’L-FAḌL.	1
i-Abhár	i-Abhar	1
i-Ishtahardi] told me, "If I could get hold of a copy of the Persian _Bayán_, I would read something out of it to you." I said: "It can be found." "Where?" enquired S_hayk_h Abu-Turab. I replied that Ḥájí ‘Abdu’l-Majíd-i-S_hírází	‘Abdu’l-Majíd()-i-S_hírází	1
interpreter--Khan--as	interpreter--K_hán--as	1
mBahá’íssion',599	mBahá'ission',599	1
mit_hqáls[*]	mithqals[*]	1
mit_hqáls[1]	mithqals[1]	1
non-S_hayk_hi	non-Shaykhi	1
non-S_hayk_his.	non-Shaykhis.	1
ofBahá’ísm	ofBahá'ism	1
oth-Bábs'u'll6h	oth-Babs'u'll6h	1
pro-‘Abbásid	pro-Abbasid	1
s_hayk_hs [S_hayk_hs],	sheiks [Shaykhs],	1
suBahá’íssion',418	suBahá'ission',418	1
suBahá’íssiveness'.	suBahá'issiveness'.	1
suBahá’íttingly	suBahá'ittingly	1
túmáns),	tumáns),	1
túmáns)	tumans)	1
túmáns."	tumans."	1
túmáns.[18]	tumans.[18]	1
túmáns1	tumans1	1
túmáns[*]	tumans[*]	1
túmáns[+]	tumans[+]	1
túmáns[2]	tumans[2]	1
túmáns[3]	tumans[3]	1
unfBahá’íliar	unfBahá'iliar	1
|Ḥadít_hs	|Hádíths	1
~'Qamus-i-Íqánl~.	~'Qamus-i-Iqanl~.	1
~bimdBahá’íReb&ms	~bimdBahá'iReb&ms	1
Áqáy-i-Kás_háni,	Áqáy-i-Kás_hání,	1
Áqáy-i-Kás_háni	Áqáy-i-Kás_hání	1
Íqáng,	Ikang,	1
Íqáni	Iqani	1
‘ABBÁSI	'ABBASI	1
‘ABBÁSID	'ABBASID	1
‘ABBÁSIYAN	'ABBASIYAN	1
‘ABDU’L-BAHÁiS	‘ABDU’L-BAHAiS	1
‘ABDU’L-HAMID	‘ABDU’L-ḤAMÍD	1
‘ABDU’L-MAJID	‘ABDU’L-MAJÍD()	1
‘ABDU’LHAHA	ABDULHAHA	1
‘ALÍ AKBAR FURUTAN	‘ALÍ-AKBAR FURÚTAN	1
‘ALÍ-MUḤAMMAD,	‘ALÍ MUḤAMMAD,	1
‘Abbás-i-Nuri.	‘Abbás-i-Núrí.	1
‘Abbás-i-Ṭihráni,	‘Abbás-i-Tihrani,	1
‘Abbásabad,	'Abbasabad,	1
‘Abbásabad,	Abbasabad,	1
‘Abbásabad	'Abbasabad	1
‘Abbásabad.	'Abbasabad.	1
‘Abbásah,	'Abbasah,	1
‘Abbásah	'Abbasah	1
‘Abbási,	'Abbasi,	1
‘Abbási.	'Abbasi.	1
‘Abbási.	‘Abbasi.	1
‘Abbásid,	'Abbasid,	1
‘Abbásid,	‘Abbasid,	1
‘Abbáside	'Abbaside	1
‘Abbáside	Abbaside	1
‘Abbásids;	'Abbasids;	1
‘Abbásids[1]	'Abbasids[1]	1
‘Abbásiyya.	'Abbasiyya.	1
‘Abbáss,[1]	Abbass,[1]	1
‘Abbáss	Abbass	1
‘Abbássides	Abbassides	1
‘Abbássieh,	Abbassieh,	1
‘Abdu’l-BaháG.	‘Abdu’l-BahaG.	1
‘Abdu’l-BaháI&,	‘Abdu’l-Bahá’í&,	1
‘Abdu’l-Baháfound	‘Abdu’l-Bahafound	1
‘Abdu’l-Bahár's	‘Abdu’l-Bahar's	1
‘Abdu’l-Bahár	‘Abdu’l-Bahar	1
‘Abdu’l-Bahár.	‘Abdu’l Behar.	1
‘Abdu’l-Bahás's	‘Abdu’l-Bahas's	1
‘Abdu’l-Bahát,	‘Abdu’l-Bahat,	1
‘Abdu’l-Baházg5	‘Abdu’l-Bahazg5	1
‘Abdu’l-Bahá’ímmediately	‘Abdu’l-Baháimmediately	1
‘Abdu’l-Bábs's	‘Abdu’l-Babs's	1
‘Abdu’l-Bábs,	‘Abdu’l-Babs,	1
‘Abdu’l-Majíd-i-Maraghi'i.	‘Abdu’l-Majíd()-i-Maraghi'i.	1
‘Abdu’l-Majíd-i-Nishapuri	‘Abdu’l-Majíd()-i-Nishapuri	1
‘Abdu’l-Majíd-i-S_hírází--the	‘Abdu’l-Majíd()-i-S_hírází--the	1
‘Abdu’l-Majíd-i-Shalfurush	‘Abdu’l-Majíd()-i-Shalfurush	1
‘Abdu’l-Majíd:	‘Abdu’l-Majíd():	1
‘Abdu’l-Ḥusayn-i-Ṭihráni	‘Abdu’l-Ḥusayn-i-Tihrani	1
‘Abdu’l-Ḥusayn-i-Ṭihráni.	‘Abdu’l-Ḥusayn-i-Tihrani.	1
‘Abdu’lB&4,	Abdu'lB&4,	1
‘Abdu’lB&d's	Abdu'lB&d's	1
‘Abdu’lB&d,	Abdu'lB&d,	1
‘Abdu’lBaG	Abdu'lBaG	1
‘Abdu’lBabB's	Abdu'lBabB's	1
‘Abdu’lBah&	Abdu'lBah&	1
‘Abdu’lBah2	Abdu'lBah2	1
‘Abdu’lBah2s	Abdu'lBah2s	1
‘Abdu’lBah5	Abdu'lBah5	1
‘Abdu’lBah6	Abdu'lBah6	1
‘Abdu’lBahA	Abdu'lBahA	1
‘Abdu’lBahP's	Abdu'lBahP's	1
‘Abdu’lBahd,	Abdu'lBahd,	1
‘Abdu’lBahi]	Abdu'lBahi]	1
‘Abdu’lBahti,	Abdu'lBahti,	1
‘Abdu’lBalG	Abdu'lBalG	1
‘Abdu’lBshB,	Abdu'lBshB,	1
‘Abdu’lBti,	Abdu'lBti,	1
‘Abdu’lFL&5's	Abdu'lFL&5's	1
‘Abdu’lVahháb's	‘Abdu'lVahháb's	1
‘Abdu’lbahas	Abdulbahas	1
‘Abdu’lhaha	Abdulhaha	1
‘Abdu’lla	Abdulla	1
‘Abdu’llahabad,	'Abdu'llahabad,	1
‘Abdu’llahi-Bahbahani	'Abdu'llahi-Bahbahani	1
‘Abdu’llahi	Abdullahi	1
‘Abdu’llal1	'Abdu'llal1	1
‘Abdu’lldh	'Abdu'lldh	1
‘Abdu’lláh's	Abdulláh's	1
‘Abdu’lláh,	'Abdu'lláh,	1
‘Abdu’lláh	Abdulláh	1
‘Abdu’lláh	‘Abdu'lláh	1
‘Abdu’lláh-i-Nuri,	‘Abdu’lláh-i-Núrí,	1
‘Abdu’lláh-i-Ubayy	‘Abdu'lláh-i-Ubayy	1
‘Abdu’lláh.	'Abdu'lláh.	1
‘Akkár	'Akkar	1
“Alláho’Abhás”	“Allaho’Abhas”	1
‘AlíAkbariShahmirzadi,	‘AlíAkbariS_háhmirzadi,	1
‘Alí-Akbar-i-Shahmiradi,	‘Alí-Akbar-i-S_háhmiradi,	1
‘Alí-Akbar-i-Shahmirzad,	‘Alí-Akbar-i-S_háhmirzad,	1
‘Alí-Akbar-i-Shahmirzadi--a	‘Alí-Akbar-i-S_háhmirzadi--a	1
‘Alí-Akbar-i-Shahmirzadi[2]	‘Alí-Akbar-i-S_háhmirzadi[2]	1
‘Alí-Khan-i-Mah-Ku'i	‘Alí-K_hán-i-Mah-Ku'i	1
‘Alí-Khan-i-Nuri,	‘Alí-K_hán-i-Núrí,	1
‘Alí-Muḥammad,'	‘Alí Muḥammad,'	1
‘Alí-Muḥammad-i-Varqá	‘Alí Muḥammad-i-Varqá	1
‘Ulamás,	Ulemas,	1
‘Ulamás."	Ulemas."	1
Ḥasan-i-Bahjístani	Ḥasan-i-Bajistani	1
Ḥasan-i-Bahjístani_.	Ḥasan-i-Bajistani_.	1
Ḥasan-i-Mázindaráni	Ḥasan-i-Mázindarání	1
Ḥasan-i-Mázindaráni[1]	Ḥasan-i-Mázindarání[1]	1
Ḥaẓírat'ul-Quds: "...Ḥaẓíras	Ḥaẓíratu’l-Quds: "...Haziras	1
Ḥaẓíratu'I-Quds,	Haziratu'I-Quds,	1
Ḥaẓíratu'lQuds	Haziratu'lQuds	1
Ḥaẓíratu'lQuds_56_	Haziratu'lQuds_56_	1
Ḥaẓíratu'l-Ques	Haziratu'l-Ques	1
Ḥaẓíratu’l-Qudses	Haziratu'l-Qudses	1
Ṭihráni's	Tehrani's	1
Ṭihráni,	Teherani,	1
Ṭihráni,[24]	Tihrani,[24]	1
Ṭihráni	Tehrani	1
Ṭihráni:	Teherani:	1
Ṭihránis;	Teheranis;	1
Ṭihráni’s	Tihrani’s	1
Ṭihránlto	Teheranlto	1
Ṭihrání,	Tihrání,	1
Ḥusayn-'Aliy-i-Nuri)	Ḥusayn-'Aliy-i-Núrí)	1
Ḥusayn-Khan-i-Mushiru'd-Dawlih[1]	Ḥusayn-K_hán-i-Mushiru'd-Dawlih[1]	1
Ḥusayn-i-Kás_háni,	Ḥusayn-i-Kás_hání,	1
Ḥusayn-i-Kás_háni.	Ḥusayn-i-Kás_hání.	1
Ḥusayn-i-Rawdih-Khan--a	Ḥusayn-i-Rawdih-K_hán--a	1
Ḥusayn-i-S_hírázíy-i-Khurtumi	Ḥusayn-i-S_híráziy-i-Khurtumi	1
Ḥusayn-i-Sharif-i-Kás_háni.	Ḥusayn-i-Sharif-i-Kás_hání.	1
Ḥáfiẓes,	Hafizes,	1
Ṭáhirihd.	Tahirid.	1
Ṭáhirihds[1]	Tahirids[1]	1
ḤájíMírzá	HájíMírzá	1
Ḥájíb	Hajib	1
Ḥájíbu'dDawlih	Hajibu'dDawlih	1
Ḥájíbu'd-Datilih,	Hajibu'd-Datilih,	1
Ḥájíbu'd-Dawlih;	Hajibu'd-Dawlih;	1
Ḥájíbu'ld-Dawlih?	Hajibu'ld-Dawlih?	1
Ḥájís!	Hajis!	1
‘‘Umars,	‘Umars,	1
‘‘Umars	‘Umars	1
“Ḥájíb-ed-Dawla,”	“Hajib-ed-Dawla,”	1
"Alláh–u–Abhá!"	"Alláh-u-Abhá!"	2
"Alláh–u–Abhá!	"Alláh-u-Abhá!	2
"Alláh–u–Abhá,"	"Alláh-u-Abhá,"	2
"BAHÁ’ÍST	"BAHAIST	2
"Bahá’íyyih"	"Bahá'iyyih"	2
"S_hahnáz"	"S_háhnaz"	2
"Shogi",	"Shoghi",	2
"Shogi	"Shoghi	2
"‘Abdu’l-Majíd!	"‘Abdu’l-Majíd()!	2
'ABBUD	'ABBÚD	2
'ABDU'R-RAHIM	'ABDU'R-RAḤÍM	2
'Aliy-i-Nuri,	'Aliy-i-Núrí,	2
'Alláhu	'Allahu	2
'Alláh–u–Abhá!'	'Alláh-u-Abhá!'	2
'Alláh–u–Abhá',	'Alláh-u-Abhá',	2
'Bahá’ísm',	'Bahá'ism',	2
'Bahá’ísm'	'Bahá'ism'	2
'INAYATU'LLAH	‘INÁYATU’LLÁH	2
'Shahristani',	'S_háhristani',	2
(HAFIZ,	(ḤÁFIẒ,	2
(Mírzáy-i-S_hírází),	(Mirzay-i-S_hírází),	2
(Súrahs	(Surihs	2
(_Bahá’ísmus_	(_Bahá'ismus_	2
Abhándlungen	Abhandlungen	2
Abhár.	Abhar.	2
Abu’l-Faḍle	Abu’l Faḍle	2
Alláh–u–Abhá'!	Alláh-u-Abhá'!	2
Alláh–u–Abhá,."[3]	Alláh-u-Abhá,."[3]	2
BAHÁ’U’LLÁHS	BAHAULLAHS	2
BEGAN:	BÍQÁN:	2
Bahjítabad	Behjetabad	2
Bahás,	Bahas,	2
Bahá’u’lláhs',	Bahá'u'lláhs',	2
Bahá’u’lláhs'	Bahá'u'llahs'	2
Bahá’u’lláhs_,	Bahá'u'llahs_,	2
Bahá’u’lláhs_	Bahá'u'llahs_	2
Bahá’u’lláhs_.	Bahá'u'lláhs_.	2
Bahá’íMessage	Bahá'iMessage	2
Bahá’íe,	Bahá'ie,	2
Bahá’íe	Bahá'íe	2
Bahá’íe:	Bahá'íe:	2
Bahá’íes	Bahá'ies	2
Bahá’íes.	Bahá'íes.	2
Bahá’íi'is	Bahá'ii'is	2
Bahá’íi	Bahá'ii	2
Bahá’ímw,	Bahá'imw,	2
Bahá’ísm".	Bahaism".	2
Bahá’ísm',	Bahá'ism',	2
Bahá’ísm',	Bahá'ísm',	2
Bahá’ísm'.	Bahaism'.	2
Bahá’ísm.	Bahá'ísm.	2
Bahá’ísm_	Bahaism_	2
Bahá’ísme_.	Bahaisme_.	2
Bahá’ísmus--Religion	Bahá'ismus--Religion	2
Bahá’ísmu~,	Bahá'ismu~,	2
Bahá’ísmvs,	Bahá'ismvs,	2
Bahá’ísm·	Bahá'ism·	2
Bahá’ísts	Bahá'ists	2
Bahá’íte	Bahaite	2
Bahá’ítes	Bahaites	2
Bayánis,	Bayanis,	2
Bábs'is	Babs'is	2
FURUTAN,	FURÚTAN,	2
Fayd-i-Kás_háni's	Fayd-i-Kás_hání's	2
Faḍil-i-Ṭihráni,	Faḍil-i-Tihrani,	2
HAYDAR ‘ALÍ,	ḤAYDAR-‘ALÍ,	2
HONOUR,	HONÚR,	2
IBRAHIM	IBRAḤÍM	2
Ibn-i-Abhár;	Ibn-i-Abhar;	2
Ibrahim-i-Abhári,	Ibrahim-i-Abhari,	2
Iṣfahání	Esphahani	2
JALALIYYIH	JALÁLIYYIH	2
Jinab-i-Ibn-i-Abhár,	Jinab-i-Ibn-i-Abhar,	2
KHADIJIH	KHÁDÍJIH	2
KHAN-I-SHAVIRDI	K_HÁN-I-SHAVIRDI	2
Khan-Atash	K_hán-Atash	2
Khan-i-'Avamid,	K_hán-i-'Avamid,	2
Khan-i-Afshar,	K_hán-i-Afshar,	2
Khan-i-Farahani,	K_hán-i-Farahani,	2
Khan-i-Farrash-Bashi,	K_hán-i-Farrash-Bashi,	2
Khan-i-Ghaffari,	K_hán-i-Ghaffari,	2
Khan-i-Iravani,	K_hán-i-Iravani,	2
Khan-i-Irvani	K_hán-i-Irvani	2
Khan-i-Khu'i,	K_hán-i-Khu'i,	2
Khan-i-Mukri	K_hán-i-Mukri	2
Khan-i-Qájár,	K_hán-i-Qájár,	2
Khan-i-Qájár	K_hán-i-Qájár	2
Khan-i-Sadar	K_hán-i-Sadar	2
Khan-i-Sadar.	K_hán-i-Sadar.	2
Khan-i-Sarraf	K_hán-i-Sarraf	2
Khan-i-Shavirdi	K_hán-i-Shavirdi	2
Khan-i-Shaybani	K_hán-i-Shaybani	2
Khan-i-Turk,	K_hán-i-Turk,	2
Khan-i-Validih,	K_hán-i-Validih,	2
Khan-i-Validih	K_hán-i-Validih	2
Khan-i-Varqá,	K_hán-i-Varqá,	2
Khan-i-Vujdani	K_hán-i-Vujdani	2
Khan-i-Zand,	K_hán-i-Zand,	2
Kás_hánih,	Kashanih,	2
Káẓim-i-Ras_hti's	Káẓim-i-Ras_htí's	2
LUTFU'LLAH HAKIM	LUṬFU’LLÁH ḤAKÍM	2
MAS_HRIQU’L-AD_HKÁR	MASHRIQU'L- ADHKAR	2
MAS_HRIQU’L-AD_HKÁRS	MASHRIQU'L- ADHKARS	2
MAS_HRIQU’L-AD_HKÁRS.	MASHRIQU'L-ADHKARS.	2
MIHDI	MIHDÍ	2
MUḤÁJÍRS	MUHAJIRS	2
Mafhúm-i-Babíyyat	Mafhúm-i-Bábíyyat	2
Mas_hriqu’l-Ad_hkárs	Mashrekol Azkars	2
Maḥmúd-i-Kás_háni[1]	Maḥmúd-i-Kás_hání[1]	2
Mihdíy-i-Ras_hti's	Mihdíy-i-Ras_htí's	2
Mullás.	Mullahs.	2
Mullás.	Mullas.	2
Muḥammad-Baqir-i-Ras_hti,	Muḥammad-Baqir-i-Ras_htí,	2
Muḥammad-i-Mázindaráni,	Muḥammad-i-Mázindarání,	2
Muḥammad-i-Mázindaráni.	Muḥammad-i-Mázindarání.	2
Muḥammad-‘Alís,	Muḥammad-'Alis,	2
Muḥammad-‘Alíy-i-'Attar,	Muḥammad-'Aliy-i-'Attar,	2
Muḥammad-‘Alíy-i-Mahallati,	Muḥammad-'Aliy-i-Mahallati,	2
Muḥammad-‘Alíy-i-Nahri:	Muḥammad-'Aliy-i-Nahri:	2
Muḥammad-‘Alíy-i-Qa'ini,	Muḥammad-'Aliy-i-Qa'ini,	2
Muḥammad-‘Alíy-i-Sabbagh	Muḥammad-'Aliy-i-Sabbagh	2
Muḥammad-‘Alíy-i-Yazdí	Muḥammad-'Aliy-i-Yazdí	2
Muḥammad-‘Alíy-i-Zunuzi	Muḥammad-'Aliy-i-Zunuzi	2
Muḥammad-‘Alíy-i-Zunuzi.	Muḥammad-'Aliy-i-Zunuzi.	2
Mírzápur	Mirzapur	2
Mírzáy-i-Afnán	Mirzay-i-Afnán	2
Mírzáy-i-Halabi-Saz	Mirzay-i-Halabi-Saz	2
Mírzáy-i-Mawzun	Mirzay-i-Mawzun	2
Mírzáy-i-S_hírází.	Mirzay-i-S_hírází.	2
NABIL'S	NABÍL'S	2
NABIL	NABÍL	2
NAWRUZ	NAW-RÚZ	2
Nuri'd-Din--the	Núrí'd-Din--the	2
Nuri;	Núrí;	2
Náqiḍíne	Náqiḍene	2
Núri’d-Dín	Núrí’d-Dín	2
Pás_háliks	Pashaliks	2
Pás_háy-i-Qibrisi	Pashay-i-Qibrisi	2
Qayyúmu’l-Asmá’s	Qayyúmu’l-Asmá’'s	2
RUHIYYIH RABBANI'S	RÚḤÍYYIH RABBÁNÍ'S	2
Ras_hti's	Ras_htí's	2
SAMANDARI	SAMANDARÍ	2
SHIRAZ.	S_HÍRÁZ.	2
SIYAH-CHAL	SÍYÁH-C_HÁL	2
SULAYMAN	SULAYMÁN	2
SULTAN	SULṬÁN	2
S_HAYK_HISM	SHAYKHISM	2
S_hayk_hi.	Shaykhi.	2
S_hayk_hs,	Shaykhs,	2
S_hayk_hs	Sheikhs	2
S_hayk_hu'l-'Iraqayn,	Shaykhu'l-'Iraqayn,	2
S_hayk_hu'l-Islám,[1]	Shaykhu'l-Islám,[1]	2
S_hayk_hu'r-Ra'is:	Shaykhu'r-Ra'is:	2
S_hayk_hu'sh-Shari'a,	Shaykhu'sh-Shari'a,	2
S_hayk_hu'sh-Shari'a	Shaykhu'sh-Shari'a	2
S_hayk_hu't	Shaykhu't	2
S_hayk_hís.	Shaykhís.	2
S_hírázi	Sherazi	2
S_hírázís,	S_hírázis,	2
S_hí‘ahs,	Shiahs,	2
Sa‘ídu'd-Dawlih,	Sa'idu'd-Dawlih,	2
Shahab	S_háhab	2
Shahabad,	S_háhabad,	2
Shaheen	S_háheen	2
Shahenshah	S_háhenshah	2
Shahenshah."	S_háhenshah."	2
Shahid-i-Thalith--the	S_háhid-i-Thalith--the	2
Shahid.	S_háhid.	2
Shahidi	S_háhidi	2
Shahinshah	S_háhinshah	2
Shahr-Khwastan,	S_háhr-Khwastan,	2
Shahr-banu,	S_háhr-banu,	2
Shahriyar.	S_háhriyar.	2
Shahrough	S_háhrough	2
Shahrud.	S_háhrud.	2
Shahs!	S_háhs!	2
Shogi	Shoghi	2
Shogie	Shoghi	2
Sháhzádih	S_háhzádih	2
Siyyids	Seyeds	2
TABARSI	ṬABARSÍ	2
Taqiy-i-Abhári,	Taqiy-i-Abhari,	2
Yaḥyáh,	Yahyah,	2
Yaḥyáy-i-Dawlatabadi,	Yahyay-i-Dawlatabadi,	2
Yaḥyáy-i-Dárábí	Yahyáy-i-Dárábí	2
_Alláh–u–Abhás_	_Alláh-u-Abhas_	2
_Bahá’ísm	_Bahaism	2
_Bahá’ítum	_Bahá'itum	2
ash-Shahristani,	ash-S_háhristani,	2
beginning,--‘Alí-Muḥammad	beginning,--‘Alí Muḥammad	2
suBahá’ítting	suBahá'itting	2
túmáns,	tumáns,	2
túmáns	tumáns	2
túmáns[1]	tumans[1]	2
Áqá. Áqá	Áqa. Áqa	2
Áqáy-i	Áqay-i	2
Íqáni,	Ighani,	2
Íqáni.	Ighani.	2
‘ALÍ-MUḤAMMAD	‘ALÍ MUḤAMMAD	2
‘Abbás-'Aliy-i-Nuri,	‘Abbás-'Aliy-i-Núrí,	2
‘Abbásabad	Abbasabad	2
‘Abbásid (‘Abbási)	'Abbasid ('Abbasi)	2
‘Abbásids--the	'Abbasids--the	2
‘Abbásside	Abbasside	2
‘Abdu’l-Karím-i-Ṭihrání,	‘Abdu’l-Karím-i-Tihrání,	2
‘Abdu’l-Majíd-i-S_hírází,	‘Abdu’l-Majíd()-i-S_hírází,	2
‘Abdu’laziz,	Abdulaziz,	2
‘Akkádemia	Accademia	2
‘Alí-Akbar-i-Shahmirzadi,[F1]	‘Alí-Akbar-i-S_háhmirzadi,[F1]	2
Ḥaẓíras	Haziras	2
Ṭihráni,	Tehrani,	2
Ḥusayn-'Aliy-i-Nuri,	Ḥusayn-'Aliy-i-Núrí,	2
Ḥusayn-i-Sharif-i-Kás_háni,	Ḥusayn-i-Sharif-i-Kás_hání,	2
Ḥáfiẓiyye	Hafiziyye	2
Ḥájíbu'd-Dawlih--who	Hajibu'd-Dawlih--who	2
Ḥájíyyih	Hajiyyih	2
"Alláh–u–Abhá."	"Alláh-u-Abhá."	3
"Alláh–u–Abhá.	"Alláh-u-Abhá.	3
"Bahá’ísm	"Bahaism	3
'Abbúdwas	'Abbudwas	3
'Alláh–u–Abhá.'	'Alláh-u-Abhá.'	3
'Bahá’ísm	'Bahá'ism	3
(S_hí‘ahs)	(Shi'ahs)	3
ABU'L-FADL	ABU’L-FAḌL	3
Abhándlung	Abhandlung	3
Abhár,	Abhar,	3
Abhár	Abhar	3
Azali.	Azalí.	3
BANANI	BANÁNÍ	3
BAYAN	BAYÁN	3
Babísm_,	Bábísm_,	3
Bahjíh,	Bahjeh,	3
Bahá’u’lláhs',	Bahá'u'llahs',	3
Bahá’íS	Bahá'iS	3
Bahá’íe	Bahaie	3
Bahá’íes	Bahá'íes	3
Bahá’ísm',	Bahaism',	3
Bahá’ísm'	Bahá'ism'	3
Bahá’ísm:	Bahaism:	3
Bahá’ísmo."	Bahaismo."	3
Bahá’íyyeh	Bahá'iyyeh	3
Buzurg-i-Nuri.	Buzurg-i-Núrí.	3
FADIL-I-MAZINDARANI,	FAḌIL-I-MÁZINDARÁNÍ,	3
FURUTAN	FURÚTAN	3
HAKIM	ḤAKÍM	3
HAYDAR-‘ALÍ	ḤAYDAR-‘ALÍ	3
Ibn-i-Abhár.	Ibn-i-Abhar.	3
Iṣfahánís,	Isfahanis,	3
Khan--the	K_hán--the	3
Khan-i-'Arab,	K_hán-i-'Arab,	3
Khan-i-Afrukhtih	K_hán-i-Afrukhtih	3
Khan-i-Farrash-Bashi	K_hán-i-Farrash-Bashi	3
Khan-i-Kalantar.	K_hán-i-Kalantar.	3
Khan-i-Kirmani.	K_hán-i-Kirmani.	3
Khan-i-Larijani,	K_hán-i-Larijani,	3
Khan-i-Navváb,	K_hán-i-Navváb,	3
Khan-i-Qazvini	K_hán-i-Qazvini	3
Khan-i-Sardar,	K_hán-i-Sardar,	3
Khan-i-Shavirdi.	K_hán-i-Shavirdi.	3
Khan-i-Suq-i-Abiyad	K_hán-i-Suq-i-Abiyad	3
Khan-i-Turkaman	K_hán-i-Turkaman	3
Khan-i-Vazir	K_hán-i-Vazir	3
Kás_hánih	Kashanih	3
MIHDI,	MIHDÍ,	3
MUNIRIH	MUNÍRIH	3
Majíd	Majíd()	3
Mullás,	Mullahs,	3
Muḥammad-Ibrahim-i-Kás_háni.	Muḥammad-Ibrahim-i-Kás_hání.	3
Muḥammad-i-Mázindaráni	Muḥammad-i-Mázindarání	3
Muḥammad-‘Alíy-i-Barfurushi	Muḥammad-'Aliy-i-Barfurushi	3
Muḥammad-‘Alíy-i-Faizi,	Muḥammad-'Aliy-i-Faizi,	3
Muḥammad-‘Alíy-i-Iṣfahání.	Muḥammad-'Aliy-i-Iṣfahání.	3
Muḥammad-‘Alíy-i-Jilawdar	Muḥammad-'Aliy-i-Jilawdar	3
Muḥammad-‘Alíy-i-Zanjani	Muḥammad-'Aliy-i-Zanjani	3
Muḥammad-‘Alíy-i-Zunuzi,	Muḥammad-'Aliy-i-Zunuzi,	3
Muḥammad-‘Alíy-i	Muḥammad-'Alíy-i	3
NAW-RUZ	NAW-RÚZ	3
Nuri'd-Din's	Núrí'd-Din's	3
Nuri.	Núrí.	3
Pás_hás,	Pashas,	3
Qájárs'	Qajars'	3
Qájárs.	Qajars.	3
ROUHANI	RÚḤÁNI	3
SHIRAZ,	S_HÍRÁZ,	3
S_hayk_hie	Shaykhie	3
S_hayk_hs.	Shaykhs.	3
S_hayk_hu't-Ta'ifa's	Shaykhu't-Ta'ifa's	3
S_hí‘ahs.	Shi'ihs.	3
Sa‘ídah,	Sa’idah,	3
Sa‘ídu'l-'Ulama,	Sa'idu'l-'Ulama,	3
Shahid Ibn-i-Shahid	S_háhid Ibn-i-S_háhid	3
Shahid,	S_háhid,	3
Shahrivar	S_háhrivar	3
Shahriyar	S_háhriyar	3
Shahrukh,	S_háhrukh,	3
Shahs,	S_háhs,	3
Sháhs	S_háhs	3
Siyyids,	Seyeds,	3
TEHERAN,	ṬIHRÁN,	3
Yaḥyáh.	Yahyah.	3
Yaḥyáy-i-Dárábí,	Yahyáy-i-Dárábí,	3
_Mas_hriqu’l-Ad_hkárs_	_Mashriqu'l-Adhkárs_	3
_Shahnamih_	_S_háhnamih_	3
non-S_hayk_his	non-Shaykhis	3
túmáns),	tumans),	3
‘Abbás-i-Nuri,	‘Abbás-i-Núrí,	3
‘Abbásian	Abbasian	3
‘Abbásid	‘Abbasid	3
‘Abbásids,	Abbasids,	3
‘Abdu’l-Bahár	‘Abdu’l Behar	3
‘Abdu’l-Majíd-i-Nishapuri,	‘Abdu’l-Majíd()-i-Nishapuri,	3
‘Abdu’l-Majíd-i-S_hírází.	‘Abdu’l-Majíd()-i-S_hírází.	3
‘Alí-Muḥammad's	‘Alí Muḥammad's	3
Ḥasan-i-Mázindaráni,	Ḥasan-i-Mázindarání,	3
Ḥaẓíras.	Haziras.	3
Ṭihráni.	Tihrani.	3
Ṭáhirihds	Tahirids	3
"Alláhu	"Allahu	4
"Bahá’íst	"Bahaist	4
'Alláh–u–Abhá'.	'Alláh-u-Abhá'.	4
(Bahá’ísmus,	(Bahá'ismus,	4
(Ibn-i-Abhár)	(Ibn-i-Abhar)	4
Alláho’Abhá	Allaho’Abhá	4
Bahá’ísmus',	Bahá'ismus',	4
Bahá’ísmus.	Bahá'ismus.	4
Bahá’ísts,	Bahaists,	4
Bahá’ítum	Bahá'itum	4
Bábs'i	Babs'i	4
Fayd-i-Kás_háni,	Fayd-i-Kás_hání,	4
HAYDAR-‘ALÍ,	ḤAYDAR-‘ALÍ,	4
HAZIRATU'L-QUDS	ḤAẒÍRATU’L-QUDS	4
IMAMS	IMÁMS	4
KHAN	K_HÁN	4
KHURASAN	K_HURASÁN	4
Khan-i-Larijani	K_hán-i-Larijani	4
Khan-i-Sardar	K_hán-i-Sardar	4
Khan-i-Valí,	K_hán-i-Valí,	4
Khan-i	K_hán-i	4
LOTFULLAH HAKIM	LUṬFU’LLÁH ḤAKÍM	4
MAS_HRIQU’L-AD_HKÁRS	MASHRIQU'L-ADHKARS	4
MULLA	MULLÁ	4
Mihdíy-i-Ras_hti,	Mihdíy-i-Ras_htí,	4
Mihdíy-i-Ras_hti	Mihdíy-i-Ras_htí	4
Mullás,	Mullas,	4
Mullás.	Mollahs.	4
Muníreh	Munírih	4
Muḥammad-‘Alíy-i-Barfurushi,	Muḥammad-'Aliy-i-Barfurushi,	4
Muḥammad-‘Alíy-i-Iṣfahání,	Muḥammad-'Aliy-i-Iṣfahání,	4
Muḥammad-‘Alíy-i-Qa'ini	Muḥammad-'Aliy-i-Qa'ini	4
Muḥammad-‘Alíy-i-Tabrizi	Muḥammad-'Aliy-i-Tabrizi	4
Muḥammad-‘Alíy-i-Tambaku-Furush	Muḥammad-'Aliy-i-Tambaku-Furush	4
Pás_hás.	Pashas.	4
S_hayk_hi-Bábí	Shaykhi-Bábí	4
S_hayk_hi-und	Shaykhi-und	4
S_hayk_hism.	Shaykhism.	4
S_hayk_hu'r-Ra'is's	Shaykhu'r-Ra'is's	4
S_hayk_hu'r-Ra'is.	Shaykhu'r-Ra'is.	4
S_hírázís	S_hírázis	4
Sa'id.	Sa‘íd.	4
Shahabad	S_háhabad	4
Shahr-Banu,	S_háhr-Banu,	4
Shahrashub	S_háhrashub	4
Shahristani,	S_háhristani,	4
Shahriyar,	S_háhriyar,	4
Shahvirdi,	S_háhvirdi,	4
TAHIRIH	ṬÁHIRIH	4
YAHYA	YAḤYÁ	4
_mit_hqáls_	_mithqals_	4
s_hayk_hs	sheiks	4
‘ABDU’L-BAHÁS	ABDULBAHAS	4
‘Abdu’l-Karím-i-Ṭihrání	‘Abdu’l-Karím-i-Tihrání	4
‘Abdu’l-Majíd.	‘Abdu’l-Majíd().	4
‘Abdu’lláh,	Abdulláh,	4
‘Alí-Muḥammad.	‘Alí Muḥammad.	4
‘Ulamás	Ulemas	4
Ḥaẓírat'ul-Quds	Ḥaẓíratu’l-Quds	4
Ḥaẓíratu'l-	Haziratu'l-	4
Ṭihráni	Teherani	4
ABU'L-FADL,	ABU’L-FAḌL,	5
Azali,	Azalí,	5
Azali]	Azalí]	5
Aḥmad-i-Kás_háni	Aḥmad-i-Kás_hání	5
Bahá’u’lláhs	Bahá'u'llahs	5
Bahá’íe,	Bahá'íe,	5
Bahá’ísmrrs,	Bahá'ismrrs,	5
Bahá’ísmus-Monographie	Bahá'ismus-Monographie	5
Bahá’íst	Bahá'ist	5
JALAL	JALÁL	5
KHAN.	K_HÁN.	5
Khan-i-'Avamid	K_hán-i-'Avamid	5
Khan-i-'Avamid.	K_hán-i-'Avamid.	5
Khan-i-Valí	K_hán-i-Valí	5
Khan-i-Varqá	K_hán-i-Varqá	5
Majíd-i-Ahi,	Majíd()-i-Ahi,	5
Muḥammad-‘Alíy-i-Nahri,	Muḥammad-'Aliy-i-Nahri,	5
Mázindaráni,	Mázindarání,	5
S_hayk_hu'r-Ra'is,	Shaykhu'r-Ra'is,	5
Shahmirzad	S_háhmirzad	5
Shahrud,	S_háhrud,	5
Shahrukh	S_háhrukh	5
Shahts	S_háhts	5
Yaḥyáh	Yahyah	5
_Bahá’ísm:	_Bahaism:	5
_túmáns_.	_tumans_.	5
‘Abdu’l-Baháa	‘Abdu’l-Bahaa	5
‘Abdu’l-Karim-i-Ṭihráni,	‘Abdu’l-Karim-i-Tihrani,	5
Ḥusayn-i-Kás_háni	Ḥusayn-i-Kás_hání	5
Ḥáfiẓu'llah	Hafizu'llah	5
Abu-Sa'id,	Abu-Sa‘íd,	6
Alláho	Allaho	6
BAGHDAD	BAG_HDÁD	6
Bahá’ísmo	Bahaismo	6
Khan-i-Afrukhtih,	K_hán-i-Afrukhtih,	6
Kás_háni.	Kás_hání.	6
Muḥammad-‘Alíy-i	Muḥammad-'Aliy-i	6
Mázindaráni	Mázindarání	6
SULAYMANI,	SULAYMÁNI,	6
S_hayk_his.	Shaykhis.	6
S_hayk_hu't-	Shaykhu't-	6
Shahanshah	S_háhanshah	6
Shahi	S_háhi	6
Shahrashub,	S_háhrashub,	6
Tang-i-Alláhu	Tang-i-Allahu	6
_túmáns_,	_tumans_,	6
‘ABDU’L-HAMID.	‘ABDU’L-ḤAMÍD.	6
‘Abdu’l-Ḥusayn-i-Ṭihráni,	‘Abdu’l-Ḥusayn-i-Tihrani,	6
"Alláh–u–Abhá",	"Alláh-u-Abhá",	7
"Alláh–u–Abhá".	"Alláh-u-Abhá".	7
(Alláhu	(Allahu	7
Aḥmad-i-Kás_háni,	Aḥmad-i-Kás_hání,	7
Buzurg-i-Nuri,	Buzurg-i-Núrí,	7
Faḍil-i-Mázindaráni	Faḍil-i-Mázindarání	7
Khan-i-Navváb	K_hán-i-Navváb	7
Khan-i-Shavirdi,	K_hán-i-Shavirdi,	7
Mas_hriqu’l-Ad_hkárs,	Mashriqu'l-Adhkars,	7
Mullás,	Mollahs,	7
Muḥammad-‘Alíy-i-Salmani,	Muḥammad-'Aliy-i-Salmani,	7
S_hayk_hu'l-Islám,	Shaykhu'l-Islám,	7
TEHERAN	ṬIHRÁN	7
Vazir-i-Nuri,	Vazir-i-Núrí,	7
Alláh–u–Abhá,	Alláh-u-Abhá,	8
Bahá’ísm.	Bahaism.	8
Bahá’ísmus	Bahá'ismus	8
Maḥmúd-i-Kás_háni	Maḥmúd-i-Kás_hání	8
Muḥammad-‘Alíy-i-Iṣfahání	Muḥammad-'Aliy-i-Iṣfahání	8
Muḥammad-‘Alíy-i-Nahri	Muḥammad-'Aliy-i-Nahri	8
Nuri'd-Din,	Núrí'd-Din,	8
S_hayk_hi,	Shaykhi,	8
S_hayk_hs	Sheiks	8
S_hí‘ahs,	Shi'ihs,	8
Shahr-banu	S_háhr-banu	8
Shahsavan	S_háhsavan	8
Shahvirdi	S_háhvirdi	8
Yaḥyáy-i-Dárábí	Yahyay-i-Dárábí	8
Ṭáhirihd	Tahirid	8
Ḥájíbu'd-Dawlih.	Hajibu'd-Dawlih.	8
'Alláh–u–Abhá'	'Alláh-u-Abhá'	9
Abu-Sa'id	Abu-Sa‘íd	9
Alláhabad	Allahabad	9
Alláh–u–Abhá!	Alláh-u-Abhá!	9
Bahá’ísmw,	Bahá'ismw,	9
Bábs	Babs	9
Iṣfahánís	Isfahanis	9
Khan-i-Núrí	K_hán-i-Núrí	9
Maḥmúd-i-Kás_háni,	Maḥmúd-i-Kás_hání,	9
NABIL-I-A'ZAM	NABÍL-I-A'ZAM	9
Sa‘ídu'l-'Ulama	Sa'idu'l-'Ulama	9
Shahr-Banu	S_háhr-Banu	9
suBahá’ít	suBahá'it	9
suBahá’ítted	suBahá'itted	9
‘Abdu’lláh	'Abdu'lláh	9
AQA	ÁQÁ	10
Bahá’ímus,	Bahá'imus,	10
Ibn-i-Abhár,	Ibn-i-Abhar,	10
Nuri'd-Din	Núrí'd-Din	10
Nuri,	Núrí,	10
Pás_hás	Pashas	10
Ras_hti,	Ras_htí,	10
S_hayk_hi-gari,	Shaykhi-gari,	10
S_hayk_hism,	Shaykhism,	10
S_hayk_hu't-Ta'ifa,	Shaykhu't-Ta'ifa,	10
_Alláhs	_Allahs	10
túmáns.	tumans.	10
‘Abbásids	Abbasids	10
Ṭihráni,	Tihrani,	10
Bahá’íes,	Bahá'ies,	11
Mírzáy-i-S_hírází,	Mirzay-i-S_hírází,	11
S_hayk_hís	Shaykhís	11
mit_hqáls	mithqals	11
‘Abbásids.	'Abbasids.	11
‘Abdu’l-Majíd,	‘Abdu’l-Majíd(),	11
Ṭihráni	Tihrani	11
Bahá’ísm,	Bahá'ism,	12
Bahá’ísts	Bahaists	12
Khan-i-Qazvini,	K_hán-i-Qazvini,	12
Mírzáy-i-S_hírází	Mirzay-i-S_hírází	12
S_hayk_hs	Shaykhs	12
S_hayk_hu'l-Islám	Shaykhu'l-Islám	12
S_hayk_hí	Shaykhí	12
Súrahs	Surihs	12
Yaḥyáy-i-Dárábí,	Yahyay-i-Dárábí,	12
túmáns,	tumans,	12
Bahá’ísm,	Bahaism,	13
Khan-i-Kirmani	K_hán-i-Kirmani	13
Muḥammad-‘Alíy-i-Salmani	Muḥammad-'Aliy-i-Salmani	13
S_hí‘ahs	Shiahs	13
Sa'id_,	Sa‘íd_,	13
_túmáns_	_tumans_	13
‘Alí-Akbar-i-Shahmirzadi,	‘Alí-Akbar-i-S_háhmirzadi,	13
Alláhabad,	Allahabad,	14
Faḍil-i-Mázindaráni,	Faḍil-i-Mázindarání,	14
Khan-i-Kirmani,	K_hán-i-Kirmani,	14
Káẓim-i-Ras_hti.	Káẓim-i-Ras_htí.	14
S_hahnáz	S_háhnaz	14
"Alláh–u–Abhá"	"Alláh-u-Abhá"	15
Bahá’ísm.	Bahá'ism.	15
Ras_hti	Ras_htí	15
Shahs	S_háhs	15
suBahá’íssion	suBahá'ission	15
BAHJI	BAHJÍ	16
Bahá’íst	Bahaist	16
S_hí‘ahs,	Shi'ahs,	16
Qájárs,	Qajars,	17
S_hí‘ahs.	Shi'ahs.	17
Kás_háni,	Kás_hání,	18
Kás_háni	Kás_hání	18
Káẓim-i-Ras_hti	Káẓim-i-Ras_htí	18
Mullás	Mullahs	18
Ḥájíbu'd-Dawlih,	Hajibu'd-Dawlih,	18
Bahá’íyyih	Bahá'íyyih	19
HONOUR	HONÚR	19
‘Abbásids,	'Abbasids,	19
Alláh–u–Abhá	Alláh-u-Abhá	20
Bahá’íyyih	Bahá'iyyih	20
S_hayk_his,	Shaykhis,	20
Mas_hriqu’l-Ad_hkárs	Mashriqu'l-Adhkars	21
Khan-i-'Arab	K_hán-i-'Arab	22
Khan-i-Nuri,	K_hán-i-Núrí,	22
Káẓim-i-Ras_hti,	Káẓim-i-Ras_htí,	22
Sa'id,	Sa‘íd,	22
‘Abbásid	Abbasid	24
S_hayk_hu't-Ta'ifa	Shaykhu't-Ta'ifa	25
‘Abdu’l-Majíd	‘Abdu’l-Majíd()	25
RUHIYYIH	RÚḤÍYYIH	26
‘Alí-Muḥammad,	‘Alí Muḥammad,	27
SHIRAZ	S_HÍRÁZ	28
S_hí‘ahs	Shi'ihs	28
Mullás	Mollahs	31
Mullás	Mullas	31
S_hayk_hism	Shaykhism	35
S_hayk_hu'r-Ra'is	Shaykhu'r-Ra'is	38
Qájárs	Qajars	39
Sa'id	Sa‘íd	45
Shahid	S_háhid	46
S_hí‘ahs	Shi'ahs	51
‘Abbásids	'Abbasids	51
Bahá’ísmus,	Bahá'ismus,	52
Bahá’ísm	Bahá'ism	53
Bahá’ísm	Bahaism	55
MUḤÁJÍR	MUHAJIR	55
S_hayk_his	Shaykhis	56
Ibn-i-Abhár	Ibn-i-Abhar	58
‘Abdu’l-Bahás	‘Abdu’l-Bahas	58
Ḥájíbu'd-Dawlih	Hajibu'd-Dawlih	58
túmáns	tumans	70
Azali	Azalí	83
‘Abbásid	'Abbasid	103
‘Alí-Muḥammad	‘Alí Muḥammad	155
S_hayk_hi	Shaykhi	169
